revision: 1073355
title: Sarah Alexander
url: https://ga.wikipedia.org/wiki/Stardust_(scann%C3%A1n_2007)


---

Is scannán é Stardust atá bunaithe ar an leabhar le Neil Gaiman a bhfuil an t-ainm céanna air. B'é Matthew Vaughn stiúrthóir an scannáin. Tháinig an scannán ar an scáileán ar an 10 Lúnasa sa bhliain 2007.


== Carachtair ==
Charlie Cox - Tristan Thorn
Claire Danes - Yvaine
Michelle Pfeiffer - Lamia
Robert DeNiro - Captain Shakespeare of the Caspartine
Mark Strong - Septimus
Nathaniel Parker - Dunstan Thorn
Ben Barnes - Young Dunstan Thorn
Kate Magowan - Una
Sienna Miller - Victoria Foresster
Peter O'Toole - King of Stormhold
Jason Flemyng - Primus
Joanna Scanlan - Mormo
Sarah Alexander - Empusa
Rupert Everett - Secundus
Ricky Gervais - Ferdy the Fence
Mark Heap - Tertius
Adam Buxton - Quintus
Julian Rhind-Tutt - Quartus
David Walliams - Sextus
Melanie Hill - Ditchwater Sal
David Kelly - Guard
Mark Williams - Billy
Dexter Fletcher - Skinny Pirate
Henry Cavill - Humphrey
Sir Ian McKellen - Narrator
Jake Curran - Bernard


== Naisc sheachtracha ==
Suíomh oifigiúil


== Tagairtí ==