revision: 1073470
title: Ken McGregor
url: https://ga.wikipedia.org/wiki/Star_Wars_Episode_VII:_The_Force_Awakens


---

Scannán is ea Star Wars Episode VII: The Force Awakens (2015). Is é J. J. Abrams stiúrthóir an scannán. Is é an seachtú cheann de naoi scannáin Star Wars.


== Carachtair ==
Harrison Ford - Han Solo
Mark Hamill - Luke Skywalker
Carrie Fisher - Princess Leia Organa
Adam Driver - Kylo Ren
Daisy Ridley - Rey
John Boyega - Finn
Oscar Isaac - Poe Dameron
Lupita Nyong'o - Maz Kanata
Andy Serkis - Supreme Leader Snoke
Domhnall Gleeson - General Hux
Anthony Daniels - C-3PO
Peter Mayhew agus Joonas Suotamo - Chewbacca
Max von Sydow - Lor San Tekka
Tim Rose - Admiral Ackbar
Mike Quinn - Nien Nunb
Ewan McGregor - Obi-Wan Kenobi
Gwendoline Christie - Captain Phasma
Ken Leung - Statura
Simon Pegg - Unkar Plutt
Greg Grunberg - Temmin "Snap" Wexley
Kiran Shah - Teedo
Jessica Henwick - Jess "Testor" Pava
Brian Vernel - Bala-Tik


== Naisc sheachtracha ==


== Tagairtí ==