revision: 1069353
title: 'The Chronicles of Narnia: The Voyage of the Dawn Treader'
url: https://ga.wikipedia.org/wiki/The_Chronicles_of_Narnia:_The_Voyage_of_the_Dawn_Treader


---

Is scannán é The Chronicles of Narnia: The Voyage of the Dawn Treader atá bunaithe ar an leabhar le C. S. Lewis a bhfuil an t-ainm céanna air. Ba é Michael Apted stiúrthóir an scannáin. Tháinig an scannán ar an scáileán ar an 9ú lá de Mhí na Nollaig sa bhliain 2010.


== Carachtair ==


=== Pevensies agus Scrubbs ===
Edmund Pevensie - Skandar Keynes
Lucy Pevensie - Georgie Henley
Eustace Scrubb - Will Poulter


=== Dawn Treader ===
King Caspian - Ben Barnes
Reepicheep - Simon Pegg
Lord Drinian - Gary Sweet
Tavros - Shane Rangi
Randy - Morgan Evans
Nausus - Steven Rooke
Rynelf - Tony Nixon


=== Narnians ===
Aslan - Liam Neeson
Lilliandil - Laura Brent
Coriakin - Bille Brown
Lord Bern - Terry Norris
Lord Rhoop - Bruce Spence
Gael - Arabella Morton
Caspian IX - Nathaniel Parker
Governor Gumpas - David Vallon
Chief Dufflepud - Roy Billing


== Féach freisin ==


== Naisc sheachtracha ==
Suíomh oifigiúil


== Tagairtí ==