revision: 4796610
title: Tottori Airport
url: https://hi.wikipedia.org/wiki/%E0%A4%B5%E0%A4%BF%E0%A4%AE%E0%A4%BE%E0%A4%A8%E0%A4%95%E0%A5%8D%E0%A4%B7%E0%A5%87%E0%A4%A4%E0%A5%8D%E0%A4%B0%E0%A5%8B%E0%A4%82_%E0%A4%95%E0%A5%80_%E0%A4%B8%E0%A5%82%E0%A4%9A%E0%A5%80_ICAO_%E0%A4%95%E0%A5%8B%E0%A4%A1_%E0%A4%85%E0%A4%A8%E0%A5%81%E0%A4%B8%E0%A4%BE%E0%A4%B0:_R


---

Format of entries is:

ICAO (IATA) – Airport Name – Airport Location


== RC - Taiwan ==
Also see airport category and list.

RCBS (KNH) – Kinmen Airport – Kinmen
RCCM (CMJ) – Cimei Airport – Cimei
RCFG (LZN) – Matsu Nangan Airport – Nangan
RCFN (TTT) – Taitung Airport – Taitung
RCGI (GNI) – Lyudao Airport – Lyudao
RCKH (KHH) – Kaohsiung International Airport – Kaohsiung City
RCKU (CYI) – Chiayi Airport – Chiayi
RCKW (HCN) – Hengchun Airport – Hengchun
RCLY (KYD) – Lanyu Airport – Lanyu (Orchid Island)
RCMQ (RMQ) – Taichung Airport – Taichung
RCMT (MFK) – Matsu Beigan Airport – Matsu Islands
RCNN (TNN) – Tainan Airport – Tainan City
RCPO – Hsinchu Air Base – Hsinchu
RCQC (MZG) – Makung Airport – Makung
RCSQ (PIF) – Pingtung Airport – Pingtung
RCSS (TSA) – Taipei Songshan Airport – Taipei City
RCTP (TPE) – Taiwan Taoyuan International Airport – Taipei
RCWA (WOT) – Wangan Airport – Wang-an
RCYU (HUN) – Hualien Airport – Hualien


== RJ RO - Japan ==
Also see airport category and list.


=== RJ ===
RJAA (NRT) – Narita International Airport (New Tokyo) – Narita, Chiba
RJAF (MMJ) – Matsumoto Airport – Matsumoto, Nagano
RJAH – Hyakuri Airfield (military base; civil aviation facility under construction; to open as Ibaraki Airport) – Omitama, Ibaraki
RJAM – Minami Torishima Airport – Minami Torishima
RJAN – Niijima Airport – Niijima, Tokyo
RJAW (IWO) – Iwo Jima Air Base – Iwo Jima, Bonin Islands
RJAZ – Kozushima Airport – Kozushima, Tokyo
RJBB (KIX) – Kansai International Airport – Osaka
RJBD (SHM) – Nanki-Shirahama Airport – Shirahama, Wakayama
RJBE (UKB) – Kobe Airport – Kobe, Hyōgo
RJBH (HIW) – Hiroshima-Nishi Airport – Hiroshima, Hiroshima
RJBT (TJH) – Tajima Airport – Tajima, Hyōgo
RJCB (OBO) – Obihiro Airport (Tokachi-Obihiro) – Obihiro, Hokkaido
RJCC (CTS) – New Chitose Airport – Chitose, Hokkaido (near Sapporo)
RJCH (HKD) – Hakodate Airport – Hakodate, Hokkaido
RJCJ – Chitose Air Base (was Chitose Airport until 1988) – Chitose, Hokkaido (near Sapporo)
RJCK (KUH) – Kushiro Airport – Kushiro, Hokkaido
RJCM (MMB) – Memanbetsu Airport – Ozora, Hokkaido
RJCN (SHB) – Nakashibetsu Airport – Nakashibetsu, Hokkaido
RJCO (OKD) – Okadama Airport (Sapporo Okadama) – Sapporo, Hokkaido
RJCR (RBJ) – Rebun Airport – Rebun, Hokkaido
RJCW (WKJ) – Wakkanai Airport – Wakkanai, Hokkaido
RJDA – Amakusa Airport – Amakusa, Kumamoto
RJDB (IKI) – Iki Airport – Iki, Nagasaki
RJDC (UBJ) – Yamaguchi Ube Airport – Ube, Yamaguchi
RJDK – Kamigoto Airport – Shinkamigoto, Nagasaki
RJDO – Ojika Airport (Nagasaki Ojika) – Ojika, Nagasaki
RJDT (TSJ) – Tsushima Airport – Tsushima, Nagasaki
RJEB (MBE) – Monbetsu Airport (Okhotsk-Monbetsu) – Monbetsu, Hokkaido
RJEC (AKJ) – Asahikawa Airport – Asahikawa, Hokkaido
RJEO (OIR) – Okushiri Airport – Okushiri, Hokkaido
RJER (RIS) – Rishiri Airport – Rishirifuji, Hokkaido
RJFC (KUM) – Yakushima Airport – Yakushima, Kagoshima
RJFE (FUJ) – Goto-Fukue Airport – Gotō, Nagasaki
RJFF (FUK) – Fukuoka Airport – Fukuoka, Fukuoka
RJFG (TNE) – New Tanegashima Airport – Tanegashima, Kagoshima
RJFK (KOJ) – Kagoshima Airport – Mizobe, Kagoshima
RJFM (KMI) – Miyazaki Airport – Miyazaki, Miyazaki
RJFO (OIT) – Oita Airport – Musashi, Oita
RJFR (KKJ) – New Kitakyushu Airport – Kitakyushu, Fukuoka
RJFS (HSG) – Saga Airport – Kawasoe, Saga
RJFT (KMJ) – Kumamoto Airport – Mashiki, Kumamoto
RJFU (NGS) – Nagasaki Airport – Omura, Nagasaki
RJGG (NGO) – Chubu Centrair International Airport (Central Japan) – Nagoya, Aichi
RJKA (ASJ) – Amami Airport – Amami Ōshima, Kagoshima
RJKB (OKE) – Okinoerabu Airport – Wadomari, Kagoshima
RJKI (KKX) – Kikai Airport – Kikai, Kagoshima
RJKN (TKN) – Tokunoshima Airport – Tokunoshima, Kagoshima
RJNA (NKM) – Nagoya Airport (Komaki) – Nagoya, Aichi
RJNF (FKJ) – Fukui Airport – Harue, Fukui
RJNK (KMQ) – Komatsu Airport – Komatsu, Ishikawa
RJNO (OKI) – Oki Airport – Okinoshima, Shimane
RJNT (TOY) – Toyama Airport – Toyama, Toyama
RJNW (NTQ) – Noto Airport – Wajima, Ishikawa
RJOA (HIJ) – Hiroshima Airport – Mihara, Hiroshima
RJOB (OKJ) – Okayama Airport – Okayama, Okayama
RJOC (IZO) – Izumo Airport – Hikawa, Shimane
RJOH (YGJ) – Miho-Yonago Airport – Yonago, Tottori
RJOK (KCZ) – Kochi Airport – Nankoku, Kochi
RJOM (MYJ) – Matsuyama Airport – Matsuyama, Ehime
RJOO (ITM) – Osaka International Airport (Itami) – Itami, Hyogo
RJOR (TTJ) – Tottori Airport – Tottori, Tottori
RJOS (TKS) – Tokushima Airport – Matsushige, Tokushima
RJOT (TAK) – Takamatsu Airport – Takamatsu, Kagawa
RJOW (IWJ) – Iwami Airport – Masuda, Shimane
RJOY – Yao Airport – Yao, Osaka
RJSA (AOJ) – Aomori Airport – Aomori, Aomori
RJSC (GAJ) – Yamagata Airport – Higashine, Yamagata
RJSD (SDS) – Sado Airport – Sado Island, Niigata
RJSF (FKS) – Fukushima Airport – Tamakawa, Fukushima
RJSI (HNA) – Hanamaki Airport – Hanamaki, Iwate
RJSK (AXT) – Akita Airport – Akita, Akita
RJSM (MSJ) – Misawa Air Base / Misawa Airport – Misawa, Aomori
RJSN (KIJ) – Niigata Airport – Niigata, Niigata
RJSR (ONJ) – Odate-Noshiro Airport – Kitaakita, Akita
RJSS (SDJ) – Sendai Airport – Natori, Miyagi (near Sendai)
RJSU – Katsuminome Airport – Sendai
RJSY (SYO) – Shonai Airport – Sakata, Yamagata
RJTA (NJA) – Naval Air Facility Atsugi
RJTC – Tachikawa Airfield – Tachikawa, Tokyo
RJTF – Chofu Airport – Chōfu, Tokyo
RJTH (HAC) – Hachijojima Airport – Hachijojima, Tokyo
RJTK Kisarazu Auxiliary Landing Field – Kisarazu, Chiba
RJTO (OIM) – Oshima Airport – Izu Ōshima, Tokyo
RJTQ (MYE) – Miyakejima Airport – Miyakejima, Tokyo
RJTT (HND) – Tokyo International Airport (Haneda) – Ota, Tokyo
RJTY (OKO) – Yokota Air Base – (suburbs of Tokyo)


=== RO ===
ROAH (OKA) – Naha Airport – Naha, Okinawa
RODN (DNA) – Kadena Air Base – Okinawa City, Okinawa
ROIG (ISG) – Ishigaki Airport – Ishigaki, Okinawa
ROIT – Oitakenou Airport – Oitakenou, Ōita
ROKJ (UEO) – Kumejima Airport – Kumejima, Okinawa
ROKR (KJP) – Kerama Airport – Zamami, Okinawa
ROMD (MMD) – Minami-Daito Airport (New Minamidaito) – Minamidaito, Okinawa
ROMY (MMY) – Miyako Airport – Miyako-jima, Okinawa
RORA (AGJ) – Aguni Airport – Aguni, Okinawa
RORE (IEJ) – Iejima Airport – Ie, Okinawa
RORH (HTR) – Hateruma Airport – Taketomi, Okinawa
RORK (KTD) – Kita-Daito Airport – Kitadaito, Okinawa
RORS (SHI) – Shimojishima Airport – Irabu, Okinawa
RORT (TRA) – Tarama Airport – Tarama, Okinawa
RORY (RNJ) – Yoron Airport – Yoron, Kagoshima
ROTM – Futenma – Ginowan, Okinawa
ROYN (OGN) – Yonaguni Airport – Yonaguni, Okinawa


== RK - South Korea ==
Also see airport category and list.

RKJB (MWX) – Muan International Airport – Muan
RKJJ (KWJ) – Gwangju Airport – Gwangju
RKJK (KUV) – Gunsan Airport – Gunsan
RKJM (MPK) – Mokpo Airport – Yeongam County (near Mokpo)
RKJK (KUV) – Kunsan Air Base – Kunsan
RKJY (RSU) – Yeosu Airport – Yeosu
RKND (SHO) – Sokcho Airport – Sokcho
RKNN (KAG) – Gangneung Airbase – Kangnung
RKNW (WJU) – Wonju Airport – Wonju
RKNY (YNY) – Yangyang International Airport – Yangyang County
RKPC (CJU) – Jeju International Airport – Jeju
RKPK (PUS) – Gimhae International Airport – Pusan
RKPS (HIN) – Sacheon Airport – Sacheon
RKPU (USN) – Ulsan Airport – Ulsan
RKSI (ICN) – Incheon International Airport – Incheon (near Seoul)
RKSM (SSN) – Seoul Airbase – Seongnam
RKSO (OSN) – Osan Air Base – Osan
RKSS (GMP) – Gimpo International Airport – Seoul
RKTE – Seongmu Airport – Seongmu
RKTH (KPO) – Pohang Airport – Pohang
RKTN (TAE) – Daegu Airport – Daegu
RKTU (CJJ) – Cheongju Airport – Cheongju


== RP - Philippines ==
Also see airport category and list.

RPLB (SFS) – Subic Bay International Airport – Subic Bay
RPLC (CRK) – Diosdado Macapagal International Airport (Clark International Airport) – Manila
RPLI (LAO) – Laoag International Airport – Laoag
RPLL (MNL) – Ninoy Aquino International Airport/Villamor Airbase – Manila
RPLN – Palanan Airport – Palanan
RPLO (CYU) – Cuyo Airport – Cuyo, Palawan
RPLP (LGP) – Legazpi Airport – Legazpi
RPLU (LBX) – Lubang Airport – Lubang
RPMA (AAV) – Allah Valley Airport – Surallah
RPMR (GES) – General Santos International Airport (Buayan Airport) – General Santos
RPMC (CBO) – Awang Airport – Cotabato
RPMD (DVO) – Francisco Bangoy International Airport – Davao
RPME (BXU) – Butuan Airport (Bancasi Airport) – Butuan
RPMF (BPH) – Bislig Airport – Bislig
RPMG (DPL) – Dipolog Airport – Dipolog
RPMH (CGM) – Mambajao Airport (Camiguin Airport) – Mambajao
RPMI (IGN) – Maria Cristina Airport – Iligan
RPMJ (JOL) – Jolo Airport – Jolo
RPML (CGY) – Lumbia Airport – Cagayan De Oro
RPMM (MLP) – Malabang Airport – Malabang
RPMN (SGS) – Sanga-Sanga Airport – Bongao
RPMO (OZC) – Labo Airport – Ozamis
RPMP (PAG) – Pagadian Airport – Pagadian
RPMQ (MXI) – Imelda R. Marcos Airport – Mati
RPMS (SUG) – Surigao Airport – Surigao
RPMV (IPE) – Ipil Airport – Zamboanga del sur
RPMW (TDG) – Tandag Airport – Tandag
RPMZ (ZAM) – Zamboanga International Airport – Zamboanga
RPSM (MSN) – Panan-awan Airport – Maasin City, Southern Leyte
RPUB (BAG) – Loakan Airport – Baguio
RPUD (DTE) – Bagasbas Airport – Daet
RPUH – San Jose Airport – San Jose (Mindoro)
RPUI – Iba Airport – Iba, Zambales
RPUK – Calapan Airport – Calapan
RPUM (MBO) – Mamburao Airport – Mamburao
RPUN (WNP) – Naga Airport – Naga / Pili
RPUO (BSO) – Basco Airport – Basco
RPUQ – Mindoro Airport – Vigan
RPUR (BQA) – Baler Airport – Baler
RPUS (SFE) – San Fernando Airport – San Fernando
RPUT (TUG) – Tuguegarao Airport – Tuguegarao
RPUV (VRC) – Virac Airport – Virac
RPUW (MRQ) – Marinduque Airport – Gasan
RPUX – Plaridel Airport – Plaridel
RPUY (CYZ) – Cauayan Airport – Cauayan
RPVA (TAC) – Daniel Z. Romualdez Airport – Tacloban
RPVB (BCD) – Bacolod City Domestic Airport – Bacolod
RPVC (CYP) – Calbayog Airport – Calbayog
RPVD (DGT) – Sibulan Airport – Dumaguete City
RPVE (MPH) – Malay Airport (Godofredo P. Ramos Airport) – Caticlan/Boracay
RPVF (CRM) – Catarman National Airport – Catarman
RPVI (ILO) – Iloilo International Airport – Iloilo
RPVJ (MBT) – Masbate Airport – Masbate
RPVK (KLO) – Kalibo Airport – Kalibo
RPVM (CEB) – Mactan-Cebu International Airport – Cebu / Lapu-Lapu
RPVO (OMC) – Ormoc Airport – Ormoc
RPVP (PPS) – Puerto Princesa Airport – Puerto Princesa
RPVR (RXS) – Roxas Airport – Roxa
RPVS (SJI) – Evelio Javier Airport (formerly Antique Airport) – San Jose (Antique)
RPVT (TAG) – Tagbilaran Airport – Tagbilaran City
RPVU (TBH) – Tugdan Airport (Romblon Airport) – Tablas, Romblon
RPVV (USU) – Francisco Reyes Airport (Coran Airport) – Busuanga
RPXU – Sorsogon Airport – Sorsogon City


== References ==
"ICAO Location Indicators by State" (PDF). International Civil Aviation Organization. 2006-01-12. मूल से 26 सितंबर 2007 को पुरालेखित (PDF). अभिगमन तिथि 14 अप्रैल 2009."संयुक्त राष्ट्र Code for Trade and Transport Locations] [includes IATA codes". UN/LOCODE 2006-2. UNECE. 2007-04-30. मूल से 9 मई 2007 को पुरालेखित. अभिगमन तिथि 14 अप्रैल 2009.