revision: 5381124
title: "\xDE\xF3rsh\xF6fn"
url: https://hi.wikipedia.org/wiki/%E0%A4%B5%E0%A4%BF%E0%A4%AE%E0%A4%BE%E0%A4%A8%E0%A4%95%E0%A5%8D%E0%A4%B7%E0%A5%87%E0%A4%A4%E0%A5%8D%E0%A4%B0%E0%A5%8B%E0%A4%82_%E0%A4%95%E0%A5%80_%E0%A4%B8%E0%A5%82%E0%A4%9A%E0%A5%80_ICAO_%E0%A4%95%E0%A5%8B%E0%A4%A1_%E0%A4%85%E0%A4%A8%E0%A5%81%E0%A4%B8%E0%A4%BE%E0%A4%B0:_B


---

Format of entries is:

ICAO (IATA) – Airport Name – Airport Location


== BG – Greenland ==
Also see airport category and list.
Greenland is a self-governed territory of Denmark. Many locations in Greenland have Danish names in addition to the Greenlandic names. The Danish name, when applicable, is shown in parentheses.

BGAA  (JEG) – Aasiaat Airport – Aasiaat (Egedesminde, Ausiat)
BGAG – Aappilattoq (Qaasuitsup) Heliport – Aappilattoq, Qaasuitsup
BGAK – Akunaq Heliport – Akunaq
BGAM (AGM) – Tasiilaq Heliport – Tasiilaq (Ammassalik, Angmagssalik)
BGAP (LLU) – Alluitsup Paa Heliport – Alluitsup Paa
BGAQ – Aappilattoq (Kujalleq) Heliport – Aappilattoq, Kujalleq
BGAR (JRK) – Arsuk Heliport – Arsuk
BGAS – Ammassivik Heliport – Ammassivik
BGAT – Attu Heliport – Attu
BGBW (UAK) – Narsarsuaq Airport – Narsarsuaq (Narssarssuaq)
BGCH (JCH) – Qasigiannguit Heliport (Christianshåb Heliport) – Qasigiannguit (Christianshåb)
BGCO (CNP) – Nerlerit Inaat Airport (Constable Pynt Airport) – Jameson Land
BGEM – see BGAA
BGET – Eqalugaarsuit Heliport – Eqalugaarsuit
BGFD – Narsaq Kujalleq Heliport – Narsaq Kujalleq
BGFH – see BGPT
BGGD (JGR) – Kangilinnguit Heliport (Grønnedal Heliport) – Kangilinnguit (Grønnedal)
BGGH (GOH) – Nuuk Airport – Nuuk (Godthåb)
BGGN (JGO) – Qeqertarsuaq Heliport (Godhavn Heliport) – Qeqertarsuaq (Godhavn)
BGHB – see BGSS
BGIA – Ikerasak Heliport – Ikerasak
BGIG – Iginniarfik Heliport – Iginniarfik
BGIK – Ikerasaarsuk Heliport – Ikerasaarsuk
BGIL – Ilimanaq Heliport – Ilimanaq
BGIS – Innarsuit Heliport – Innarsuit
BGIS – Isortoq Heliport – Isortoq
BGIT – Ikamiut Heliport – Ikamiut
BGJH (JJU) – Qaqortoq Heliport (Julianehab Heliport) – Qaqortoq (Julianehab)
BGJN (JAV) – Ilulissat Airport (Jakobshavn Airport) – Ilulissat (Jakobshavn)
BGKA (QPW) – Kangaatsiaq Heliport – Kangaatsiaq
BGKK (KUS) – Kulusuk Airport – Kulusuk
BGKL – Upernavik Kujalleq Heliport – Upernavik Kujalleq
BGKM – Kuummiut Heliport – Kuummiut
BGKQ – Kullorsuaq Heliport – Kullorsuaq
BGKS – Kangersuatsiaq Heliport – Kangersuatsiaq
BGKT – Kitsissuarsuit Heliport – Kitsissuarsuit
BGLL – Illorsuit Heliport – Illorsuit
BGMO – Moriussaq Heliport – Moriusaq
BGMQ (JSU) – Maniitsoq Airport – Maniitsoq (Sukkertoppen)
BGNK – Niaqornaarsuk Heliport – Niaqornaarsuk
BGNL – Nalunaq Heliport – Nalunaq
BGNN (JNN) – Nanortalik Heliport – Nanortalik
BGNQ – Nuugaatsiaq Heliport – Nuugaatsiaq
BGNS (JNS) – Narsaq Heliport – Narsaq
BGNT – Niaqornat Heliport – Niaqornat
BGNU – Nuussuaq Heliport – Nuussuaq
BGPT (JFR) – Paamiut Airport – Paamiut (Frederikshåb)
BGQA – see BGQQ
BGQE – Qeqertaq Heliport – Qeqertaq
BGQQ  (NAQ) – Qaanaaq Airport – Qaanaaq
BGQT – Qassimiut Heliport – Qassimiut
BGSC (OBY) – Ittoqqortoormiit Heliport (Scoresbysund Heliport) – Ittoqqortoormiit (Scoresbysund)
BGSF (SFJ) – Kangerlussuaq Airport (Søndre Strømfjord Airport) – Kangerlussuaq (Søndre Strømfjord)
BGSG – Sermiligaaq Heliport – Sermiligaaq
BGSI – Siorapaluk Heliport – Siorapaluk
BGSQ – Saqqaq Heliport – Saqqaq
BGSS  (JHS) – Sisimiut Airport (Holsteinsborg Airport) – Sisimiut (Holsteinsborg)
BGST – Saattut Heliport – Saattut
BGSV – Savissivik Heliport – Savissivik
BGTA – Tasiusaq (Qaasuitsup) Heliport – Tasiusaq, Qaasuitsup
BGTL (THU) – Thule Air Base – Pituffik, Qaanaaq
BGTN – Tiniteqilaaq Heliport – Tiniteqilaaq
BGTQ – Tasiusaq (Kujalleq) Heliport – Tasiusaq, Kujalleq
BGUK  (JUV) – Upernavik Airport – Upernavik
BGUM (UMD) – Uummannaq Heliport – Uummannaq
BGUQ (JQA) – Qaarsut Airport – Qaarsut
BGUT – Ukkusissat Heliport – Ukkusissat


== B/BI – Iceland ==
Also see airport category and list.

BIAR (AEY) – Akureyri Airport – Akureyri
BIBK (BJD) – Bakkafjordur Airport – Bakkafjörður
BIBL (BLO) – Blönduós Airport – Blönduós
BIDV (DJU) – Djupivogur Airport – Djupivogur
BIEG (EGS) – Egilsstaðir Airport – Egilsstaðir
BIGR (GRY) – Grimsey Airport – Grimsey
BIHN (HFN) – Hornafjordur Airport – Höfn
BIHU (HZK) – Húsavík Airport – Húsavík
BIIS (IFJ) – Ísafjörður Airport – Ísafjörður
BIKF (KEF) – Keflavík International Airport (Flugstöð Leifs Eiríkssonar) – Keflavík
BIKP (OPA) – Kopasker Airport – Kopasker
BIKR (SAK) – Sauðárkrókur Airport – Sauðárkrókur
BINF (NOR) – Nordfjordur Airport – Nordfjordur
BIPA (PFJ) – Patreksfjordur Airport – Patreksfjordur
BIRF (OLI) – Rif Airport – Ólafsvík
BIRG (RFN) – Raufarhofn Airport – Raufarhofn
BIRK (REK) – Reykjavík Airport – Reykjavík
BISI (SIJ) – Siglufjörður Airport – Siglufjörður
BIST (SYK) – Stykkishólmur Airport – Stykkishólmur
BITE (TEY) – Thingeyri Airport – Þingeyri
BITH (THO) – Thorshofn Airport – Þórshöfn
BIVM (VEY) – Vestmannaeyjar Airport – Vestmannaeyjar
BIVO (VPN) – Vopnafjörður Airport – Vopnafjörður


== B/BK – Kosovo ==
Also see airport category and list.

BKPR / LYPR (PRN) – Pristina International Airport – Pristina


== References ==

"ICAO Location Indicators by State" (PDF). International Civil Aviation Organization. 2006-01-12. मूल से 26 सितंबर 2007 को पुरालेखित (PDF). अभिगमन तिथि 14 अप्रैल 2009."संयुक्त राष्ट्र Code for Trade and Transport Locations] [includes IATA codes". UN/LOCODE 2006-2. UNECE. 2007-04-30. मूल से 9 मई 2007 को पुरालेखित. अभिगमन तिथि 14 अप्रैल 2009."Eurocontrol EAD". Eurocontrol and KCAA (Kosovo Civil Aviation Authority). 2008-12-29. मूल से 11 जून 2003 को पुरालेखित. अभिगमन तिथि 14 अप्रैल 2009.