revision: 4796603
title: "\u0935\u093F\u092E\u093E\u0928\u0915\u094D\u0937\u0947\u0924\u094D\u0930\u094B\
  \u0902 \u0915\u0940 \u0938\u0942\u091A\u0940 ICAO \u0915\u094B\u0921 \u0905\u0928\
  \u0941\u0938\u093E\u0930: H"
url: https://hi.wikipedia.org/wiki/%E0%A4%B5%E0%A4%BF%E0%A4%AE%E0%A4%BE%E0%A4%A8%E0%A4%95%E0%A5%8D%E0%A4%B7%E0%A5%87%E0%A4%A4%E0%A5%8D%E0%A4%B0%E0%A5%8B%E0%A4%82_%E0%A4%95%E0%A5%80_%E0%A4%B8%E0%A5%82%E0%A4%9A%E0%A5%80_ICAO_%E0%A4%95%E0%A5%8B%E0%A4%A1_%E0%A4%85%E0%A4%A8%E0%A5%81%E0%A4%B8%E0%A4%BE%E0%A4%B0:_H


---

Format of entries is:

ICAO (IATA) – Airport Name – Airport Location


== HA - Ethiopia ==
Also see airport category and list.

HAAB (ADD) – Bole International Airport – Addis Ababa
HAAM (AMH) – Arba Minch Airport – Arba Minch
HAAX (AXU) – Axum Airport – Axum
HABD (BJR) – Bahir Dar Airport – Bahir Dar
HABE (BEI) – Beica Airport – Beica
HABU (BCY) – Bulchi Airport – Bulchi
HADC (DSE) – Combolcha Airport – Dessie
HADD (DEM) – Dembidolo Airport – Dembidolo
HADM (DBM) – Debre Marqos Airport – Debre Marqos
HADR (DIR) – Aba Tenna Dejazmach Yilma International Airport – Dire Dawa
HADT (DBT) – Debre Tabor Airport – Debre Tabor
HAFN (FNH) – Fincha Airport – Finicha'a
HAGB (GOB) – Robe Airport – Goba
HAGM (GMB) – Gambela Airport – Gambela
HAGN (GDQ) – Gondar Airport – Gondar
HAGO (GDE) – Gode Airport (military) – Gode
HAGR (GOR) – Gore Airport – Gore
HAHM (QHR) – Harar Meda Airport – Debre Zeyit
HAHU (HUE) – Humera Airport – Humera
HAJM (JIM) – Aba Segud Airport – Jimma
HAKD (ABK) – Kabri Dar Airport – Kabri Dar
HAKL (LFO) – Kelafo Airport – Kelafo
HALA (AWA) – Awasa Airport – Awasa
HAMK (MQX) – Alula Aba Airport – Mek'ele
HAMN (NDM) – Mendi Airport – Mendi
HAMT (MTF) – Mizan Teferi Airport – Mizan Teferi
HANG (EGL) – Neghele Airport (military) – Negele Boran
HANJ (NEJ) – Nejjo Airport – Nejo
HANK (NEK) – Nekemte Airport – Nekemte
HASO (ASO) – Asosa Airport – Asosa
HATP (TIE) – Tippi Airport – Tippi
HAWC (WAC) – Wacca Airport – Wacca


== HB - Burundi ==
Also see airport category and list.

HBBA (BJM) – Bujumbura International Airport – Bujumbura
HBBE (GID) – Gitega Airport – Gitega
HBBO (KRE) – Kirundo Airport – Kirundo


== HC - Somalia ==
Also see airport category and list.

HCMA (ALU) – Alula Airport – Alula
HCMB (BIB) – Baidoa Airport – Baidoa
HCMC (CXN) – Candala Airport – Candala
HCMD (BSY) – Bardera Airport – Bardera
HCME (HCM) – Eil Airport – Eil
HCMF (BSA) – Bender Qassim International Airport – Boosaaso
HCMG (GSR) – Gardo Airport – Gardo
HCMH (HGA) – Egal International Airport – Hargeisa
HCMI (BBO) – Berbera Airport – Berbera
HCMK (KMU) – Kisimayu Airport – Kisimayu
HCMM (MGQ) – Mogadishu Airport – Mogadishu
HCMO (CMO) – Obbia Airport – Obbia
HCMR (GLK) – Galcaio Airport – Galcaio
HCMS (CMS) – Scusciuban Airport – Scusciuban
HCMU (ERA) – Erigavo Airport – Erigavo
HCMV (BUO) – Burao Airport – Burao


== HD - Djibouti ==
Also see airport category and list.

HDAG – [[Assa-Gueyla Airport] – Assa-Gueyla
HDAM (JIB) – Djibouti-Ambouli International Airport – Djibouti City
HDAS (AII) – Ali-Sabieh Airport – Ali-Sabieh
HDCH – Chabelley Airport – Chabelley
HDDK – Dikhil Airport – Dikhil
HDHE – Herkale Airport – Herkale
HDMO (MHI) – Moucha Airport – Moucha Island
HDOB (OBC) – Obock Airport – Obock
HDTJ (TDJ) – Tadjoura Airport – Tadjoura


== HE - Egypt ==
Also see airport category and list.

HEAR (AAC) – El Arish International Airport – El Arish
HEAT (ATZ) – Asyut Airport – Assiut
HEAX (ALY) – El Nhouza Airport – Alexandria
HEBA (HBE) – Borg El Arab Airport – Alexandria
HEBL (ABS) – Abu Simbel Airport – Abu Simbel
HECA (CAI) – Cairo International Airport – Cairo
HECW (CWE) – Cairo West Airport – Cairo West
HEGN (HRG) – Hurghada Airport – Hurghada
HEGR (EGH) – El Gora Airport – El Gora
HELX (LXR) – Luxor International Airport – Luxor
HEMA (RMF) – Marsa Alam International Airport – Marsa Alam
HEMM (MUH) – Mersa Matruh Airport – Mersa Matruh
HENV (UVL) – New Valley Airport – New Valley
HEPS (PSD) – Port Said Airport – Port Said
HESC (SKV) – St. Catherine International Airport – St. Catherine
HESH (SSH) – Sharm El Sheikh Airport – Sharm El Sheikh
HESN (ASW) – Daraw Airport – Aswan
HETB (TCP) – Taba International Airport – Taba


== HH - Eritrea ==
Also see airport category and list.

HHAS (ASM) – Asmara International Airport – Asmara
HHMS (MSW) – Massawa International Airport – Massawa
HHSB (ASA) – Assab International Airport – Assab
HHTS (TES) – Teseney Airport – Teseney


== HK - Kenya ==
Also see airport category and list.

HKAM (ASV) – Amboseli Airport – Amboseli
HKEL (EDL) – Eldoret International Airport – Eldoret
HKES (EYS) – Eliye Springs Airport – Eliye Springs
HKFG (KLK) – Kalokol Airport – Kalokol
HKGA (GAS) – Garissa Airport – Garissa
HKHO (HOA) – Hola Airport – Hola
HKJK (NBO) – Jomo Kenyatta International Airport (formerly Nairobi International Airport) – Nairobi
HKKI (KIS) – Kisumu Airport – Kisumu
HKKL (ILU) – Kilaguni Airport – Kilaguni
HKKR (KEY) – Kericho Airport – Kericho
HKKT (KTL) – Kitale Airport – Kitale
HKLO (LOK) – Lodwar Airport – Lodwar
HKLU (LAU) – Manda Airport – Lamu
HKLY (LOY) – Loyengalani Airport – Loiyangalani
HKMA (NDE) – Mandera Airport – Mandera
HKMB (RBT) – Marsabit Airport – Marsabit
HKML (MYD) – Malindi Airport – Malindi
HKMO (MBA) – Moi International Airport – Mombasa
HKMY (OYL) – Moyale Lower Airport – Moyale
HKNI (NYE) – Nyeri Airport – Nyeri
HKNK (NUU) – Nakuru Airport – Nakuru
HKNW (WIL) – Wilson Airport – Nairobi
HKNY (NYK) – Nanyuki Airport – Nanyuki
HKRE – Eastleigh Airport – Nairobi
HKSB (UAS) – Samburu Airport – Samburu
HKWJ (WJR) – Wajir Airport – Wajir


== HL - Libya ==
Also see airport category and list.

HLGT (GHT) – Ghat Airport – Ghat
HLKF (AKF) – Kufra Airport – Kufra
HLLB (BEN) – Benina International Airport – Benghazi
HLLM (MJI) – Mitiga International Airport – Tripoli
HLLQ (LAQ) – La Abraq Airport – Beida
HLLS (SEB) – Sebha Airport – Sebha
HLLT (TIP) – Tripoli International Airport – Tripoli
HLMB (LMQ) – Marsa Brega Airport – Marsa Brega
HLTD (LTD) – Ghadames East Airport – Ghadames


== HR - Rwanda ==
Also see airport category and list.

HRYG (GYI) – Gisenyi Airport – Gisenyi
HRYI (BTQ) – Butare Airport – Butare
HRYR (KGL) – Kigali International Airport (formerly Gregoire Kayibanda Airport) – Kigali
HRYU (RHG) – Ruhengeri Airport – Ruhengeri
HRZA (KME) – Kamembe Airport – Cyangugu


== HS - Sudan ==
Also see airport category and list.

HSAT (ATB) – Atbara Airport – Atbara
HSDB (EDB) – Eldebba Airport – Eldebba
HSDN (DOG) – Dongola Airport – Dongola
HSFS (ELF) – El Fasher Airport – El Fasher
HSGG (DNX) – Galegu Airport – Dinder
HSGN (EGN) – Geneina Airport – Geneina
HSKA (KSL) – Kassala Airport – Kassala
HSKG (GBU) – Khashm El Girba Airport – Khashm El Girba
HSKI (KST) – Rabak Airport – Kosti
HSMR (MWE) – Merowe Airport – Merowe
HSNH (NUD) – En Nahud Airport – En Nahud
HSNL (UYL) – Nyala Airport – Nyala
HSOB (EBD) – El Obeid Airport – El Obeid
HSPN (PZU) – Port Sudan New International Airport – Port Sudan
HSSJ (JUB) – Juba Airport – Juba
HSSM (MAK) – Malakal Airport – Malakal
HSSP (PZU) – Port Sudan New International Airport – Port Sudan
HSSS (KRT) – Khartoum International Airport – Khartoum
HSSW (WHF) – Wadi Halfa Airport – Wadi Halfa
HSWW (WUU) – Wau Airport – Wau


== HT - Tanzania ==
Also see airport category and list.

HTAR (ARK) – Arusha Airport – Arusha
HTBU (BKZ) – Bukoba Airport – Bukoba
HTDA (DAR) – Dar es Salaam Airport – Dar es Salaam
HTDO (DOD) – Dodoma Airport – Dodoma
HTIR (IRI) – Iringa Airport – Iringa
HTKA (TKQ) – Kigoma Airport – Kigoma
HTKI (KIY) – Kilwa Masoko Airport – Kilwa Masoko
HTKJ (JRO) – Kilimanjaro International Airport – Mount Kilimanjaro
HTLI (LDI) – Lindi Kikwetu Airport – Lindi
HTLM (LKY) – Lake Manyara Airport – Lake Manyara
HTMA (MFA) – Mafia Airport – Mafia
HTMB (MBI) – Mbeya Airport – Mbeya
HTMD (MWN) – Mwadui Airport – Mwadui
HTMI (XMI) – Masasi Airport – Masasi
HTMS (QSI) – Moshi Airport – Moshi
HTMT (MYW) – Mtwara Airport – Mtwara
HTMU (MUZ) – Musoma Airport – Musoma
HTMW (MWZ) – Mwanza Airport – Mwanza
HTNA (NCH) – Nachingwea Airport – Nachingwea
HTNJ (JOM) – Njombe Airport – Njombe
HTPE (PMA) – Pemba Airport – Pemba
HTSN (SEU) – Seronera Airport – Seronera
HTSO (SGX) – Songea Airport – Songea
HTSU (SUT) – Sumbawanga Airport – Sumbawanga
HTSY (SHY) – Shinyanga Airport – Shinyanga
HTTB (TBO) – Tabora Airport – Tabora
HTTG (TGT) – Tanga Airport – Tanga
HTZA (ZNZ) – Zanzibar Airport – Zanzibar


== HU - Uganda ==
Also see airport category and list.

HUAR (RUA) – Arua Airport – Arua
HUEN (EBB) – Entebbe International Airport – Entebbe (near Kampala)
HUGU (ULU) – Gulu Airport – Gulu
HUJI (JIN) – Jinja Airport – Jinja
HUKC (KLA) – Kampala Airport – Kampala
HUKF (KBG) – Kabalega Falls Airport – Kabalega Falls
HUKS (KSE) – Kasese Airport – Kasese
HUMA (MBQ) – Mbarara Airport – Mbarara
HUMI (KCU) – Masindi Airport – Masindi
HUSO (SRT) – Soroti Airport – Soroti
HUTO (TRY) – Tororo Airport – Tororo


== References ==
"ICAO Location Indicators by State" (PDF). International Civil Aviation Organization. 2006-01-12. मूल से 26 सितंबर 2007 को पुरालेखित (PDF). अभिगमन तिथि 14 अप्रैल 2009."संयुक्त राष्ट्र Code for Trade and Transport Locations] [includes IATA codes". UN/LOCODE 2006-2. UNECE. 2007-04-30. मूल से 9 मई 2007 को पुरालेखित. अभिगमन तिथि 14 अप्रैल 2009.