revision: 4796605
title: Sarreguemines Neunkirch Airport
url: https://hi.wikipedia.org/wiki/%E0%A4%B5%E0%A4%BF%E0%A4%AE%E0%A4%BE%E0%A4%A8%E0%A4%95%E0%A5%8D%E0%A4%B7%E0%A5%87%E0%A4%A4%E0%A5%8D%E0%A4%B0%E0%A5%8B%E0%A4%82_%E0%A4%95%E0%A5%80_%E0%A4%B8%E0%A5%82%E0%A4%9A%E0%A5%80_ICAO_%E0%A4%95%E0%A5%8B%E0%A4%A1_%E0%A4%85%E0%A4%A8%E0%A5%81%E0%A4%B8%E0%A4%BE%E0%A4%B0:_L


---

Format of entries is:

ICAO (IATA) – Airport Name – Airport Location


== LA - Albania ==
Also see airport category and list.

LA10 – Gjirokastër Airport – Gjirokastër
LAFK – Tirana Mil Hel Airport – Tirana
LAGJ – Gjader Airport – Gjader
LAKO – Korçë Northwest Airport – Korçë
LAKU – Kukes Airport – Kukës
LAKV – Kuçovë Airport – Kuçovë
LASK – Shkodër Airport – Shkodër (Shkodra)
LASR – Sarandë Airport – Sarandë (Saranda)
LATI (TIA) – Rinas Mother Teresa Airport – Tirana
LAVL – Vlorë Airport – Vlorë (Vlora)


== LB - Bulgaria ==
Also see airport category and list.

LBBG (BOJ) – Burgas International Airport (Sarafovo Airport) – Burgas
LBBR – Ravnetz Air Base (military) – Ravnetz
LBDB - Dolna Bania (private)
LBED – Erden (private)
LBGO (GOZ) – Gorna Oryahovitsa Airport – Gorna Oryahovitsa
LBHS – Uzundzhovo Air Base (military) – Haskovo
LBIA (JAM) – Bezmer Air Base (military) – Bezmer
LBKJ – Kyrdjali
LBKK – Kazanlyk
LBLS – Lesnovo (private)
LBMG – Gabrovnitsa Air Base (military) – Gabrovnitsa (Gabrovnica)
LBMM – Montana
LBPD (PDV) – Plovdiv International Airport – Plovdiv
LBPG – Graf Ignatievo Air Base (military) – Graf Ignatievo / Plovdiv
LBPK – Pernik
LBPL (PVN) – Dolna Mitropolia Air Base (military) – Dolna Mitropoliia / Pleven
LBPR – Primorsko (private)
LBPS – Sadovo / Cheshnigirovo
LBRS (ROU) – Ruse Airport – Rousse
LBSD – Dobroslavtsi Air Base (military) – Dobroslavtsi (Dobroslavci)
LBSF (SOF) – Sofia International Airport (Vrazhdebna) – Sofia
LBSL – Sliven Airfield (military) – Sliven
LBSS (SLS) – Silistra Airfield (military) – Silistra
LBSZ (SZR) – Stara Zagora International Airport – Stara Zagora
LBTG – Bukhovtsi Airfield (military) – Tyrgovishte
LBTV – Voden
LBVD (VID) – Vidin Airfield (military) – Vidin
LBWB – Balchik Air Base (military) – Balchik
LBWC – Chaika / Varna
LBWK – Kalimanci / Varna
LBWN (VAR) – Varna International Airport – Varna


== LC - Cyprus ==
Also see airport category and list.

LCEN (ECN) – Ercan International Airport – Nicosia
LCLK (LCA) – Larnaca International Airport – Larnaca
LCNC (NIC) – Nicosia International Airport (abandoned) – Nicosia
LCPH (PFO) – Paphos International Airport – Paphos
LCRA (AKT) – RAF Akrotiri – Akrotiri


== LD - Croatia ==
Also see airport category and list.

LD57 – Sepurine Training Base – Sepurine
LDDA – Daruvar Airport – Daruvar
LDDD – Zagreb AFTN Airport – Zagreb
LDDP – Ploče Airport – Ploče
LDDU (DBV) – Dubrovnik Airport – Dubrovnik
LDLO (LSZ) – Lošinj Airport – Lošinj
LDOB – Borovo Airport – Borovo
LDOC – Čepin Airport – Čepin
LDOR – Slavonski Brod Airport – Slavonski Brod
LDOS (OSI) – Osijek Airport – Osijek
LDPL (PUY) – Pula Airport – Pula
LDPM – Medulin Airport – Medulin
LDPN – Unije Airport – Unije
LDPV – Vrsar Airport – Vrsar
LDRG – Grobničko Polje Airport – Grobnik
LDRI (RJK) – Rijeka Airport – Rijeka
LDRO – Otočac Airport – Otočac
LDSB (BWK) – Bol Airport – Brač
LDSH – Hvar Airport – Hvar
LDSP (SPU) – Split Airport – Split
LDSS – Sinj Airport – Sinj
LDVA – Varazdin Airport – Varazdin
LDVC – Čakovec Airport – Čakovec
LDVK – Koprivnica Airport – Koprivnica
LDZA (ZAG) – Zagreb Pleso Airport – Zagreb
LDZD (ZAD) – Zadar Airport – Zadar
LDZG – Zagreb City Airport – Zagreb
LDZL – Zagreb Lučko Airport – Zagreb
LDZO – Zagreb ACC Airport – Zagreb
LDZU – Udbina Airport – Udbina


== LE - Spain ==
Also see airport category and list.

LEAL (ALC) – Alicante Airport (formerly El Altet Airport) – Alicante / Benidorm / Costa Blanca
LEAM (LEI) – Almería International Airport – Almería
LEAS (OVD) – Asturias Airport – Aviles / Gijon / Oviedo (Asturias)
LEBA (ODB) – Córdoba Airport – Córdoba Andalucia
LEBB (BIO) – Bilbao Airport – Bilbao / Bilbo, Viscaya
LEBG (RGS) – Burgos Airport – Burgos, Castilla
LEBL (BCN) – Barcelona International Airport – Barcelona / El Prat de Llobregrat
LEBZ (BJZ) – Badajoz Airport – Badajoz
LECO (LCG) – La Coruña Airport – La Coruña / A Coruña, Galicia
LECU (MCV) – Cuatro Vientos Airport – Madrid
LEGE (GRO) – Girona-Costa Brava Airport – Girona / Girona (Costa Brava
LEGR (GRX) – Granada Airport – Granada
LEGT - Getafe Air Base - Getafe, Spain
LEHC (HSK) – Huesca Airport – Huesca / Pirineus
LEIB (IBZ) – Ibiza Airport – Ibiza Island / Eivisa
LEJR (XRY) – Jerez Airport – Jerez de la Frontera / Cádiz
LELC (MJV) – Murcia-San Javier Airport – Murcia /Cartagena, Region de Murcia
LELL (QSA) – Sabadell Airport – Sabadell / Catalunya
LELN (LEN) – León Airport – León / Castilla y Leon
LEMD (MAD) – Barajas International Airport – Madrid
LERL (CQM) – Ciudad Real Central Airport - Ciudad Real
LETO (TOJ) – Madrid-Torrejón Airport – Madrid
LEMG (AGP) – Málaga Airport – Málaga / Agripina / Torremolinos,Marbella,Fuengirola(Pablo Picasso)
LEMH (MAH) – Menorca Airport – Menorca,Mahon / Balearic Islands
LEPA (PMI) – Palma de Mallorca Airport (or Son Sant Joan Airport) – Palma de Mallorca
LEPP (PNA) – Pamplona Airport – Pamplona / Irunea
LERS (REU) – Reus Airport – Reus / Tarragona /Costa Daurada
LESA (SLM) – Matacán Airport – Salamanca, Castilla
LESB – Son Bonet Aerodrome – Palma de Mallorca
LESL – San Luis Aerodrome – Menorca, Balearic Islands
LESO (EAS) – San Sebastián Airport – San Sebastián - Donostia, Guypuscoa
LEST (SCQ) – Santiago de Compostela Airport – Santiago de Compostela, Galicia
LETO (TOJ) - Madrid-Torrejón Airport - Torrejón de Ardoz
LEVC (VLC) – Valencia Airport – Valencia / Manises / Costa del Azahar
LEVD (VLL) – Valladolid Airport – Valladolid /Castilla
LEVT (VIT) – Vitoria Airport – Vitoria-Gasteiz,Alava
LEVX (VGO) – Vigo-Peinador Airport – Vigo, Galicia
LEXJ (SDR) – Santander Airport – Santander / Cantabria
LEZG (ZAZ) – Zaragoza Airport – Zaragoza / Aragon
LEZL (SVQ) – San Pablo Airport – Sevilla


== LF - France ==
Also see airport category and list.

LFAB (DPE) – Dieppe - Saint-Aubin Airport – Dieppe
LFAC (CQF) – Calais - Dunkerque Airport – Calais, Dunkerque
LFAD (XCP) – Compiègne - Margny Airport – Compiègne
LFAE – Eu Mers - Le Tréport Airport – Eu, Le Tréport
LFAF (XLN) – Laon - Chambry Airport – Laon
LFAG (XSJ) – Péronne - Saint-Quentin Airport – Péronne
LFAI – Nangis - Les Loges Airport – Nangis
LFAJ – Argentan Airport – Argentan
LFAK (XDK) – Dunkerque - Les Moeres Airport – Dunkerque
LFAL – Thoree Les Pins Airport – La Flèche
LFAM – Berck-sur-Mer Airport – Berck-sur-Mer
LFAO – Bagnoles-de-l'Orne Airport – Bagnoles-de-l'Orne
LFAP – Rethel - Perthes Airport – Rethel
LFAQ – Albert-Picardie Airport – Albert
LFAR – Montdidier Airport – Montdidier
LFAS – Falaise - Monts d'Eraines Airport – Falaise
LFAT (LTQ) – Le Touquet-Paris-Plage Airport – Le Touquet-Paris-Plage
LFAU – Vauville Airport – Vauville
LFAV (XVS) – Valenciennes - Denain Airport – Valenciennes
LFAW – Villerupt Airport – Villerupt
LFAX – Mortagne-au-Perche Airport – Mortagne-au-Perche
LFAY (QAM) – Amiens - Glisy Airport – Amiens
LFAZ (SBK) – Saint-Brieuc Airport – Saint-BrieucLFBA (AGF) – Agen - La Garenne Airport – Agen
LFBD (BOD) – Bordeaux - Merignac Airport – Bordeaux
LFBE (EGC) – Bergerac - Roumanière Airport – Bergerac
LFBG (CNG) – Cognac - Chateaubernard Airport – Cognac
LFBH (LRH) – La Rochelle - Île de Ré Airport – La Rochelle
LFBI (PIS) – Poitiers - Biard Airport – Poitiers
LFBJ – Saint-Junien - Airport – Saint-Junien
LFBK (MCU) – Montluçon - Gueret Airport – Montluçon
LFBL (LIG) – Limoges - Bellegarde Airport – Limoges
LFBM (XMJ) – Mont-de-Marsan Airport – Mont-de-Marsan
LFBN (NIT) – Niort - Souche Airport – Niort
LFBO (TLS) – Toulouse - Blagnac Airport – Toulouse
LFBP (PUF) – Pau - Pyrenees Airport – Pau, Pyrenees
LFBR – Muret - Lherm Airport – Muret, Lherm
LFBS – Biscarrosse - Parentis Airport – Biscarrosse
LFBT (LDE) – Tarbes - Lourdes Pyrenees Airport – Tarbes
LFBU (ANG) – Angoulême - Brie Champniers Airport – Angoulême
LFBV (BVE) – Brive - La Roche Airport – Brive
LFBX (PGX) – Périgueux - Bassillac Airport – Périgueux
LFBY (XDA) – Dax - Seyresse Airport – Dax
LFBZ (BIQ) – Biarritz-Bayonne - Anglet Airport – Biarritz, Bayonne, AngletLFCA (XCX) – Châtellerault - Targe Airport – Châtellerault
LFCB – Bagnères-de-Luchon Airport – Bagnères-de-Luchon
LFCC (ZAO) – Cahors Lalbenque Airport – Cahors
LFCD – Andernos-les-Bains Airport – Andernos-les-Bains
LFCE (XGT) – Guéret Saint-Laurent Airport – Guéret
LFCF – Figeac Livernon Airport – Figeac
LFCG – Saint-Girons Antichan Airport – Saint-Girons
LFCH (XAC) – Arcachon La Teste-de-Buch Airport – Arcachon
LFCI (LBI) – Albi Le Sequestre Airport – Albi
LFCJ – Jonzac Neulles Airport – Jonzac
LFCK (DCM) – Castres-Mazamet Airport – Castres, Mazamet
LFCL – Toulouse-Lasbordes Airpor – Toulouse
LFCM – Millau Larzac Airport – Millau
LFCN – Nogaro Airport – Nogaro
LFCO – Oloron Herere Airport – Oloron
LFCP – Pons Avy Airport – Pons
LFCQ – Graulhet Montdragon Airport – Graulhet
LFCR (RDZ) – Rodez Marcillac Airport – Rodez
LFCS – Bordeaux Leognan saucats Airport – Bordeaux
LFCT – Thouars Airport – Thouars
LFCU – Ussel Thalamy Airport – Ussel, Thalamy
LFCV – Villefranche-de-Rouergue Airport – Villefranche-de-Rouergue
LFCW – Villeneuve-sur-Lot Airport – Villeneuve-sur-Lot
LFCX – Castelsarrazin Moissac Airport – Castelsarrasin
LFCY (RYN) – Royan Medis Airport – Royan
LFCZ – Mimizan Airport – MimizanLFDA – Aire-sur-l'Adour Airport – Aire-sur-l'Adour
LFDB (XMW) – Montauban Airport – Montauban
LFDC – Montendre Marcillac Airport – Montendre
LFDE – Egletons Airport – Egletons
LFDF – Sainte-Foy-la-Grande Airport – Sainte-Foy-la-Grande
LFDG – Gaillac Lisle-sur-Tarn Airport – Gaillac
LFDH – Auch Lamothe Airport – Auch
LFDI (XLR) – Libourne Artigues-de-Lussac Airport – Libourne
LFDJ – Pamiers Les Pujols Airport – Pamiers
LFDK – Soulac-sur-Mer Airport – Soulac-sur-Mer
LFDL – Loudun Airport – Loudun
LFDM – Marmande virazeil Airport – Marmande
LFDN (RCO) – Rochefort Saint-Agnant Airport – Rochefort
LFDP – Saint-Pierre-d'Oléron Airport – Saint-Pierre-d'Oléron
LFDQ – Castelnau Magnoac Airport – Castelnau
LFDR – La Réole Floudes Airport – La Réole
LFDS (XSL) – Sarlat Domme Airport – Sarlat
LFDT – Tarbes Laloubere Airport – Tarbes
LFDU – Lesparre Saint-Laurent Médoc Airport – Lesparre-Médoc
LFDV – Couhé Verac Airport – Couhé
LFDW – Chauvigny Airport – Chauvigny
LFDX – Fumel Montayral Airport – Fumel
LFDY – Bordeaux Yvrac Airport – BordeauxLFEA – Belle Île Airport – Belle Île
LFEB – Dinan Trelivan Airport – Dinan
LFEC – Ouessant Airport – Ouessant
LFED – Pontivy Airport – Pontivy
LFEF (XAM) – Amboise Dierre Airport – Amboise
LFEG – Argenton-sur-Creuse Airport – Argenton-sur-Creuse
LFEH – Aubigny-sur-Nère Airport – Aubigny-sur-Nère
LFEI – Briare Chatillon Airport – Briare
LFEJ – Châteauroux Villers Airport – Châteauroux
LFEK – Issoudun Le Fay Airport – Issoudun
LFEL – Le Blanc Airport – Le Blanc
LFEM – Montargis Vimory Airport – Montargis
LFEN – Tours Sorigny Airport – Tours
LFEO (XSB) – Saint-Servan Airport – Saint-Malo
LFEP – Pouilly Maconge Airport – Pouilly
LFEQ – Quiberon Airport – Quiberon
LFER (XRN) – Redon Bains-sur-Oust Airport – Redon
LFES – Guiscriff Scaer Airport – Guiscriff
LFET – Til-Châtel Airport – Til-Châtel
LFEU (XBD) – Bar-le-Duc Airport – Bar-le-Duc
LFEV – Gray Saint-Adrien Airport – Gray
LFEW – Saulieu Liernais Airport – Saulieu
LFEX – Nancy Azelot Airport – Nancy
LFEY (IDY) – Île d'Yeu Airport – Île d'Yeu
LFEZ – Nancy Malzeville Airport – NancyLFFB – Buno Bonnevaux Airport – Buno
LFFC – Mantes Cherence Airport – Mantes
LFFD – Saint-André-de-l'Eure Airport – Saint-André-de-l'Eure
LFFE – Enghien Moisselles Airport – Enghien
LFFG – La Ferté-Gaucher Airport – La Ferté-Gaucher
LFFH (XCY) – Château-Thierry Belleau Airport – Château-Thierry
LFFI – Ancenis Airport – Ancenis
LFFJ – Joinville Mussey Airport – Joinville
LFFK – Fontenay-le-Comte Airport – Fontenay-le-Comte
LFFL – Bailleau-Armenonville Airport – Bailleau-Armenonville
LFFM – Lamotte-Beuvron Airport – Lamotte-Beuvron
LFFN – Brienne-le-Château Airport – Brienne-le-Château
LFFP – Pithiviers Airport – Pithiviers
LFFQ – La Ferté-Alais Airport – La Ferté-Alais
LFFR – Bar-sur-Seine Airport – Bar-sur-Seine
LFFT – Neufchateau Rouceux Airport – Neufchâteau
LFFU – Châteauneuf-sur-Cher Airport – Châteauneuf-sur-Cher
LFFV (XVZ) – Vierzon Mereau Airport – Vierzon
LFFW – Montaigu saint georges Airport – Montaigu
LFFX – Tournus Cruisery Airport – Tournus
LFFY – Etrepagny Airport – Etrepagny
LFFZ – Sézanne Saint-Remy Airport – SézanneLFGA (CMR) – Colmar Houssen Airport – Colmar
LFGB – Mulhouse Habsheim Airport – Mulhouse
LFGC – Strasbourg Neuhof Airport – Strasbourg
LFGD – Arbois Airport – Arbois
LFGE – Avallon Airport – Avallon
LFGF (XBV) – Beaune Challanges Airport – Beaune
LFGG – Belfort Chaux Airport – Belfort
LFGH – Cosne-sur-Loire Airport – Cosne-Cours-sur-Loire
LFGI – Dijon Darois Airport – Dijon
LFGJ (DLE) – Dole - Tavaux Airport – Dole
LFGK – Joigny Airport – Joigny
LFGL (XLL) – Lons-le-Saunier Courlaoux Airport – Lons-le-Saunier
LFGM – Montceau-les-Mines Pouilloux Airport – Montceau-les-Mines
LFGN – Paray-le-Monial Airport – Paray-le-Monial
LFGO – Pont-sur-Yonne Airport – Pont-sur-Yonne
LFGP – Saint-Florentin Cheu Airport – Saint-Florentin
LFGQ – Semur-en-Auxois Airport – Semur-en-Auxois
LFGR – Doncourt-lès-Conflans Airport – Doncourt-lès-Conflans
LFGS – Longuyon Villette Airport – Longuyon
LFGT – Sarrebourg Buhl Airport – Sarrebourg
LFGU – Sarreguemines Neunkirch Airport – Sarreguemines
LFGV (XTH) – Thionville Yutz Airport – Thionville
LFGW (XVN) – Verdun Le Rozelier Airport – Verdun
LFGX – Champagnole Crotenay Airport – Champagnole
LFGY (XTD) – Saint-Dié Remomeix Airport – Saint-Dié
LFGZ – Nuits-Saint-Georges Airport – Nuits-Saint-GeorgesLFHA – Issoire Le Broc Airport – Issoire
LFHC – Pérouges Meximieux Airport – Pérouges
LFHD – Pierrelate Airport – Pierrelatte
LFHE – Romans Saint-Paul Airport – Romans-sur-Isère
LFHF – Ruoms Airport – Ruoms
LFHG – Saint-Chamond L'Horme Airport – Saint-Chamond
LFHH (XVI) – Vienne Reventin Airport – Vienne
LFHI – Morestel Airport – Morestel
LFHJ – Lyon Corbas Airport – Lyon
LFHL – Langogne Lesperon Airport – Langogne
LFHM (MVV) – Megève Airport – Megève
LFHN (XBF) – Bellegarde Vouvray Airport – Bellegarde
LFHO (OBS) – Aubenas Ardeche Meridionale Airport – Aubenas
LFHP (LPY) – Le Puy Loudes Airport – Le Puy
LFHQ – Saint-Flour Coltines Airport – Saint-Flour
LFHR – Brioude Beaumont Airport – Brioude
LFHS – Bourg Ceyzeriat Airport – Bourg
LFHT – Ambert Le Poyet Airport – Ambert
LFHU – LL'Alpe d'Huez Airport – L'Alpe d'Huez
LFHV – Villefranche Tarare Airport – Villefranche
LFHW – Belleville Villie Morgon Airport – Belleville
LFHX – Lapalisse Perigny Airport – Lapalisse
LFHY – Moulins Montbeugny Airport – Moulins
LFHZ (XSN) – Sallanches Mont-Blanc Airport – SallanchesLFIB – Belvès Saint-Pardoux Airport – Belvès
LFID – Condom Valence-sur-Baise Airport – Condom
LFIF – SSaint-Affrique Belmont Airport – Saint-Affrique
LFIG – Cassagnes Beghones Airport – Cassagnes
LFIH – Chalais Airport – Chalais
LFIK – Ribérac Saint-Aulaye Airport – Ribérac
LFIL – Rion-des-Landes Airport – Rion-des-Landes
LFIM – Saint-Gaudens Montrejeau Airport – Saint-Gaudens
LFIO (XYT) – Toulouse-Montaudran Airport – Toulouse-Montaudran
LFIP – Peyresourde Balestas Airport – Peyresourde
LFIR – Revel Montgey Airport – Revel
LFIT – Toulouse Bourg-Saint-Bernard Airport – Toulouse
LFIV – Vendays-Montalivet Airport – Vendays-Montalivet
LFIX – Itxassou Airport – Itxassou
LFIY – Saint-Jean-d'Angély Airport – Saint-Jean-d'AngélyLFJA – Chaumont Semoutiers Airport – Chaumont
LFJB – Mauléon Airport – Mauléon
LFJC – Clamecy Airport – Clamecy
LFJD – Corlier Airport – Corlier
LFJE – La Motte-Chalancon Airport – La Motte-Chalancon
LFJF – Aubenasson Airport – Aubenasson
LFJH – Cazeres Palaminy Airport – Cazères
LFJI – Marennes Airport – Marennes
LFJL (ETZ) – Metz Nancy Lorraine Airport – Metz
LFJR – Angers - Loire Airport – Angers
LFJS (XSS) – Soissons Courmelles Airport – Soissons
LFJT – Tours Le Louroux Airport – Tours
LFJU – Lurcy Levis Airport – LurcyLFKA (XAV) – Albertville Airport – Albertville
LFKB (BIA) – Bastia Poretta Airport – Bastia
LFKC (CLY) – Calvi Sainte-Catherine Airport – Calvi
LFKD – Sollières-Sardières Airport – Sollières-Sardières
LFKE – Saint-Jean-en-Royans Airport – Saint-Jean-en-Royans
LFKF (FSC) – Figari Sud Corse Airport – Figari
LFKG – Ghisonaccia Alzitone Airport – Ghisonaccia
LFKH – Saint-Jean-d'Avelanne Airport – Saint-Jean-d'Avelanne
LFKJ (AJA) – Ajaccio Campo dell'Oro Airport – Ajaccio
LFKL – Lyon Brindas Airport – Lyon
LFKM – Saint Galmier Airport – Saint-Galmier
LFKO – Propriano Airport – Propriano
LFKP – La Tour-du-Pin Cessieu Airport – La Tour-du-Pin
LFKS (SOZ) – Solenzara Airport – Solenzara
LFKT – Corte Airport – Corte
LFKX (MFX) – Meribel Bois-des-Fraisses Airport – Méribel
LFKY – Belley Peyrieu Airport – Belley
LFKZ (XTC) – Saint-Claude Pratz Airport – Saint-ClaudeLFLA (AUF) – Auxerre Branches Airport – Auxerre
LFLB (CMF) – Chambéry Aix-les-Bains Airport – Chambéry, Aix-les-Bains
LFLC (CFE) – Clermont-Ferrand Auvergne Airport – Clermont-Ferrand
LFLD (BOU) – Bourges Airport – Bourges
LFLE – Chambery Challes-les-Eaux Airport – Chambéry
LFLG – Grenoble Le Versoud Airport – Grenoble
LFLH – Chalon Champforgeuil Airport – Chalon
LFLI (QNJ) – Annemasse Airport – Annemasse
LFLJ (CVF) – Courchevel Airport – Courchevel
LFLK – Oyonnax Arbent Airport – Oyonnax
LFLL (LYS) – Lyon-Saint Exupéry Airport (formerly Satolas Airport) – Lyon
LFLM (QNX) – Mâcon Charnay Airport – Mâcon
LFLN (SYT) – Saint-Yan Airport – Saint-Yan
LFLO (RNE) – Roanne Renaison Airport – Roanne
LFLP (NCY) – Annecy Meythet Airport – Annecy
LFLQ (XMK) – Montélimar Ancone Airport – Montélimar
LFLR – Saint-Rambert-d'Albon Airport – Saint-Rambert-d'Albon
LFLS (GNB) – Grenoble Saint-Geoirs Airport – Grenoble
LFLT – Montluçon Domerat Airport – Montluçon
LFLU (VAF) – Valence Chabeuil Airport – Valence
LFLV (VHY) – Vichy Charmeil Airport – Vichy
LFLW (AUR) – Aurillac Airport – Aurillac
LFLX (CHR) – Châteauroux-Déols Airport – Châteauroux, Déols
LFLY (LYN) – Lyon Bron Airport – Lyon
LFLZ – Feurs Chambeon Airport – FeursLFMA – Aix Les Milles Airport – Aix-les-Milles
LFMC – Le Luc Le Cannet Airport – Le Luc
LFMD (CEQ) – Cannes Mandelieu Airport – Cannes
LFME – Nimes Courbessac Airport – Nîmes
LFMF – Fayence-Tourrettes Airfield – Fayence
LFMG – La Montagne Noire Airport – La Montagne Noire
LFMH (EBU) – Saint-Étienne Bouthéon Airport – Saint-Étienne
LFMI (QIE) – Istres Le Tube Airport – Istres
LFMK (CCF) – Carcassonne Salvaza Airport – Carcassonne
LFML (MRS) – Marseille Provence Airport – Marseille
LFMM (QXB) – Marseille FIR – Aix-en-Provence
LFMN (NCE) – Nice Côte d'Azur Airport – Nice
LFMO (XOG) – Orange Caritat Airport – Orange
LFMP (PGF) – Perpignan Rivesaltes Airport – Perpignan
LFMQ (CTT) – Le Castellet Airport – Le Castellet
LFMR (BAE) – Barcelonnette Saint-Pons Airport – Barcelonnette
LFMS (XAS) – Alès Deaux Airport – Alès
LFMT (MPL) – Montpellier-Méditerranée Airport – Montpellier
LFMU (BZR) – Béziers-Agde-Vias Airport – Béziers
LFMV (AVN) – Avignon Caumont Airport – Avignon
LFMW – Castelnaudary Villeneuve Airport – Castelnaudary
LFMX – Château-Arnoux Saint-Auban Airport – Château-Arnoux
LFMZ – Lezignan Corbieres Airport – LezignanLFNA (GAT) – Gap Tallard Airport – Gap
LFNB (MEN) – Mende Brenoux Airport – Mende
LFNC – Mont-Dauphin Saint-Crepin Airport – Mont-Dauphin
LFND – Pont-Saint-Esprit Airport – Pont-Saint-Esprit
LFNE – Salon Eyguieres Airport – Salon
LFNF – Vinon Airport – Vinon
LFNG – Montpellier Candillargues Airport – Montpellier
LFNH – Carpentras Airport – Carpentras
LFNJ – Aspres-sur-Buech Airport – Aspres-sur-Buëch
LFNL – Saint-Martin-de-Londres Airport – Saint-Martin-de-Londres
LFNO – Florac Sainte-Enimie Airport – Florac
LFNP – Pézenas Nizas Airport – Pézenas
LFNQ (QZE) – Mont-Louis La Quillane Airport – Mont-Louis
LFNR – Berre La Fare Airport – Berre
LFNS – Sisteron Theze Airport – Sisteron
LFNT – Avignon Pujaut Airport – Avignon
LFNU – Uzès Airport – Uzès
LFNV – Valréas Visan Airport – Valréas
LFNW – Puivert Airport – Puivert
LFNX – Bédarieux La Tour-sur-Orb Airport – Bédarieux
LFNZ – Le Mazet-de-Romanin Airport – Le MazetLFOB (BVA) – Beauvais Tillé Airport – Beauvais
LFOC – Châteaudun Airport – Châteaudun
LFOD (XSU) – Saumur Saint-Florent Airport – Saumur
LFOE (EVX) – Evreux Fauville Airport – Evreux
LFOF (XAN) – Alençon Valframbert Airport – Alençon
LFOG – Flers Saint-Paul Airport – Flers
LFOH (LEH) – Le Havre Octeville Airport – Le Havre
LFOI (XAB) – Abbeville - Buigny-Saint-Maclou Aerodrome – Abbeville
LFOJ (ORE) – Orléans Bricy Airport – Orléans
LFOK (XCR) – Chalons Vatry Airport – Châlons-en-Champagne
LFOL – L'Aigle Saint-Michel Airport – L'Aigle
LFOM – Lessay Airport – Lessay
LFON (XDR) – Dreux Vernouillet Airport – Dreux
LFOO (LSO) – Les Sables-d'Olonne Talmont Airport – Les Sables-d'Olonne
LFOP (URO) – Rouen Vallée de Seine Airport – Rouen
LFOQ (XBQ) – Blois Le Breuil Airport – Blois
LFOR (QTJ) – Chartres Champhol Airport – Chartres
LFOS – Saint-Valery Vittefleur Airport – Saint-Valery
LFOT (TUF) – Tours Val de Loire Airport – Tours
LFOU (CET) – Cholet Le Pontreau Airport – Cholet
LFOV (LVA) – Laval Entrammes Airport – Laval
LFOW – Saint-Quentin Roupy Airport – Saint-Quentin
LFOX – Étampes Montdesir Airport – Étampes
LFOY – Le Havre Saint-Romain Airport – Le Havre
LFOZ – Orléans Saint-Denis-de-l'Hotel Airport – OrléansLFPA – Persan Beaumont Airport – Persan, Beaumont
LFPB (LBJ) – Paris Le Bourget Airport – Paris
LFPC (CSF) – Creil Airport – Creil
LFPD (XBX) – Bernay Saint-Martin Airport – Bernay
LFPE – Meaux Esbly Airport – Meaux
LFPF – Beynes Thiverval Airport – Beynes
LFPG (CDG) – Paris Charles de Gaulle Airport (Roissy Airport) – Paris
LFPH – Chelles Le Pin Airport – Chelles
LFPI – Paris Issy-les-Moulineaux Airport – Paris
LFPK – Coulommiers Voisins Airport – Coulommiers
LFPL (XLG) – Lognes Emerainville Airport – Lognes
LFPM – Melun Villaroche Airport – Melun
LFPN (TNF) – Toussus-le-Noble Airport – Toussus-le-Noble
LFPO (ORY) – Paris Orly Airport – Orly (near Paris)
LFPP – Le Plessis-Belleville Airport – Le Plessis-Belleville
LFPQ – Fontenay Tresigny Airport – Fontenay
LFPT (POX) – Pontoise Cormeilles-en-Vexin Airport – Pontoise
LFPU – Moret Episy Airport – Moret
LFPV – Villacoublay Vélizy Airport – Villacoublay
LFPX – Chavenay Villepreux Airport – Chavenay
LFPY – Bretigny-sur-Orge Airport – Bretigny-sur-Orge
LFPZ – Saint-Cyr-l'École Airport – Saint-Cyr-l'ÉcoleLFQA – Reims Prunay Airport – Reims
LFQB (QYR) – Troyes Barberey Airport – Troyes
LFQC – Lunéville Croismare Airport – Lunéville
LFQD (QRV) – Arras Roclincourt Airport – Arras
LFQF – Autun Bellevue Airport – Autun
LFQG (NVS) – Nevers Fourchambault Airport – Nevers
LFQH – Châtillon-sur-Seine Airport – Châtillon-sur-Seine
LFQI (XCB) – Cambrai Epinoy Airport – Cambrai
LFQJ (XME) – Maubeuge Elesmes Airport – Maubeuge
LFQK – Chalons Ecury-sur-Coole Airport – Chalons
LFQL (XLE) – Lens Benifontaine Airport – Lens
LFQM – Besançon La Veze Airport – Besançon
LFQN (XSG) – Saint-Omer Wizernes Airport – Saint-Omer
LFQO – Lille Marcq-en-Baroeul Airport – Lille
LFQQ (LIL) – Lille Lesquin Airport – Lille
LFQR – Romilly-sur-Seine Airport – Romilly-sur-Seine
LFQS – Vitry-en-Artois Airport – Vitry-en-Artois
LFQT (HZB) – Merville Calonne Airport – Merville / Hazebrouck
LFQU – Sarre-Union Airport – Sarre-Union
LFQV (XCZ) – Charleville-Mézières Airport – Charleville-Mézières
LFQW (XVO) – Vesoul Frotey Airport – Vesoul
LFQX – Juvancourt Airport – Juvancourt
LFQY – Saverne Steinbourg Airport – Saverne
LFQZ – Dieuze Gueblange Airport – DieuzeLFRA (ANE) – Angers Avrille Airport – Angers (closed in 2003)
LFRB (BES) – Brest Bretagne Airport – Brest
LFRC (CER) – Cherbourg Maupertus Airport – Cherbourg
LFRD (DNR) – Dinard Pleurtuit Saint-Malo Airport – Dinard
LFRE (LBY) – La Baule-Escoublac Airport – La Baule-Escoublac
LFRF (GFR) – Granville Airport – Granville
LFRG (DOL) – Deauville Saint-Gatien Airport – Deauville
LFRH (LRT) – Lorient South Brittany Airport – Lorient
LFRI (EDM) – La Roche-sur-Yon Les Ajoncs Airport – La Roche-sur-Yon
LFRJ (LDV) – Landivisiau Airport – Landivisiau
LFRK (CFR) – Caen Carpiquet Airport – Caen
LFRM (LME) – Le Mans Arnage Airport – Le Mans
LFRN (RNS) – Rennes - Saint-Jacques Airport – Rennes
LFRO (LAI) – Lannion Airport – Lannion
LFRP – Ploermel Loyat Airport – Ploërmel
LFRQ (UIP) – Quimper Pluguffan Airport – Quimper
LFRS (NTE) – Nantes Atlantique Airport (formerly Aéroport Château Bougon) – Nantes
LFRT – Saint-Brieuc Armor Airport – Saint-Brieuc
LFRU (MXN) – Morlaix Ploujean Airport – Morlaix
LFRV (VNE) – Vannes Meucon Airport – Vannes
LFRW – Avranches Le Val Saint-Pere Airport – Avranches
LFRZ (SNR) – Saint-Nazaire Montoir Airport – Saint-NazaireLFSA (QBQ) – Besançon Thise Airport – Besançon
LFSB (MLH) – Bâle Mulhouse Airport (EuroAirport Basel-Mulhouse-Freiburg) – Basel (Switzerland) / Mulhouse
LFSD (DIJ) – Dijon Bourgogne - Longvic Airport – Dijon
LFSE – Epinal dogneville Airport – Epinal
LFSF (MZM) – Metz Frescaty Airport – Metz
LFSG (EPL) – Épinal Mirecourt Airport – Épinal
LFSH – Haguenau Airport – Haguenau
LFSJ (XSW) – Sedan Douzy Airport – Sedan
LFSK – Vitry-le-François Vauclerc Airport – Vitry-le-François
LFSM (XMF) – Montbéliard Courcelles Airport – Montbéliard
LFSN (ENC) – Nancy Essey Airport – Nancy
LFSP – Pontarlier Airport – Pontarlier
LFSQ (BOR) – Belfort Fontaine Airport – Belfort
LFSR (RHE) – Reims Champagne Airport – Reims
LFST (SXB) – Strasbourg Entzheim Airport – Strasbourg
LFSU – Langres Rolampont Airport – Langres
LFSV – Pont-Saint-Vincent Airport – Pont-Saint-Vincent
LFSW (XEP) – Épernay Plivot Airport – Épernay
LFSY (XCW) – Chaumont - La Vendue Airport – Chaumont
LFSZ (VTL) – Vittel Champ-de-Courses Airport – VittelLFTB – Marignane Berre Airport – Marignane
LFTF – Cuers Pierrefeu Airport – Cuers
LFTH (XHE) – Hyères Le Palyvestre Airport – Hyères
LFTM – Serres La Batie Montsaleon Airport – Serres-la-Batie
LFTN – La Grand'Combe Airport – La Grand'Combe
LFTP – Puimoisson Airport – Puimoisson
LFTQ – Chateaubriant Pouance Airport – Châteaubriant
LFTR (TLN) – Toulon Saint-Mandrier Airport – Toulon
LFTU (FRJ) – Frejus Saint-Raphael Airport – Frejus
LFTW (FNI) – Nîmes-Arles-Camargue Airport – Nîmes
LFTZ – La Mole Airport – La MoleLFXA – Amberieu Airport – Amberieu
LFXB (XST) – Saintes Thenac Airport – Saintes
LFXM – Mourmelon Airport – Mourmelon
LFXN (XNA) – Narbonne Airport – Narbonne
LFXU – Les Mureaux Airport – Les MureauxLFYG – Cambrai Niergnies Airport – Cambrai
LFYR – Romorantin Pruniers Airport – Romorantin
LFYS – Sainte-Léocadie Airport – Sainte-Léocadie


=== Saint Pierre and Miquelon ===
Also see airport category and list.

LFVM (MQC) – Miquelon Airport – Miquelon
LFVP (FSP) – Saint Pierre Airport – Saint-Pierre


== LG - Greece ==
Also see airport category and list.

LGAG (AGQ) - Agrinion Airport - Agrinion
LGAL (AXD) – Alexandroupolis International Airport, "Dimokritos" (Democritus) – Alexandroupolis
LGAD (PYR) – Andravida Airport – Andravida
LGAT (ATH) – Ellinikon International Airport (closed in 2001) – Athens
LGAV (ATH) – Athens International Airport, "Eleftherios Venizelos" – Athens (Athina)
LGBL (VOL) – International Airport of Central Greece – Nea Anchialos/Volos
LGHI (JKH) – Chios Island National Airport – Chios
LGHL (PKH) - Porto Cheli Airport - Porto Cheli, Argolis
LGIK (JIK) – Ikaria Island National Airport – Ikaria
LGIO (IOA) – Ioannina National Airport – Ioannina
LGIR (HER) – Heraklion International Airport, "Nikos Kazantzakis" – Heraklion (Iraklion), Crete
LGKA (KSO) – Kastoria National Airport, "Aristotelis" – Kastoria
LGKC (KIT) – Kithira Island National Airport – Kythira (Kithira)
LGKF (EFL) – Kefalonia Island International Airport – Kefalonia (Kefallinia, Cephallonia)
LGKJ (KZS) – Kastelorizo Island Public Airport – Kastelorizo
LGKL (KLX) – Kalamata International Airport – Kalamata
LGKN - Kotroni Airport - Marathon
LGKO (KGS) – Kos Island International Airport, "Ippokratis" (Hippocrates) – Kos
LGKP (AOK) – Karpathos Island National Airport – Karpathos
LGKR (CFU) – Ioannis Kapodistrias International Airport – Corfu (Kerkyra, Kerkira)
LGKS (KSJ) – Kassos Island Public Airport – Kasos (Kassos)
LGKV (KVA) – Kavala International Airport, "Megas Alexandros" – Kavala
LGKZ (KZI) – Kozani National Airport, "Filippos" – Kozani
LGLM (LXS) – Lemnos International Airport – Lemnos (Limnos)
LGMK (JMK) – Mykonos Island National Airport – Mykonos (Mikonos)
LGML (MLO) – Milos Island National Airport – Milos
LGMT (MJT) – Mytilene International Airport, "Odysseas Elytis" – Mytilene (Mitilini), Lesbos
LGNX (JNX) – Naxos Island National Airport – Naxos
LGPA (PAS) – Paros National Airport – Paros
LGPL (JTY) – Astypalaia Island National Airport – Astypalaia
LGPZ (PVK) – Aktion National Airport (Lefkada Airport) – Preveza
LGRP (RHO) – Rhodes International Airport, "Diagoras" – Rhodes (Rhodos, Rodos)
LGRX (GPA) – Araxos Airport – Araxos
LGSA (CHQ) – Chania International Airport, "Ioannis Daskalogiannis" – Chania, Crete
LGSK (JSI) – Skiathos Island National Airport – Skiathos
LGSM (SMI) – Samos International Airport, "Aristarchos" – Samos
LGSO (JSY) – Syros Island National Airport – Syros (Siros)
LGSP (SPJ) - Sparti Airport - Sparti, Laconia
LGSR (JTR) – Santorini (Thira) National Airport – Santorini (Thira)
LGST (JSH) – Sitia Public Airport – Sitia, Crete
LGSY (SKU) – Skyros Island National Airport – Skyros (Skiros)
LGTP - Tripolis Airport - Tripoli
LGTS (SKG) – Thessaloniki International Airport, "Makedonia" – Thessaloniki
LGTT - Tatoi Airport - Athens, Decelea
LGZA (ZTH) – Zakynthos International Airport, "Dionysios Solomos" – Zakynthos (Zakinthos)


== LH - Hungary ==
Also see airport category and list.

LH58 – Csákvár Airport – Csákvár
LHBP (BUD) – Budapest Ferihegy International Airport – Budapest
LHBS – Budaörs Airport – Budaörs
LHDC (DEB) – Debrecen International Airport – Debrecen
LHDK – Dunakeszi Airport – Dunakeszi
LHDV - Dunaújváros Airport - Dunaújváros
LHEC – Érsekcsanád Airport – Érsekcsanád
LHEM – Esztergom Airport – Esztergom
LHFM – Fertőszentmiklós Airport – Fertőszentmiklós
LHHH - Hármas-határ-hegy Airfield - Budapest
LHKE – Kecskemét Airport – Kecskemét
LHNY – Nyíregyháza Airport – Nyíregyháza
LHOY – Őcsény Airport – Őcsény
LHPA – Pápa Airport – Pápa
LHPP (PEV) – Pécs Pogány Airport – Pécs
LHPR – Győr Pér Airport – Győr, Pér
LHSA – Szentkirályszabadja Airport – Szentkirályszabadja
LHSM (SOB) – Sármellék International Airport – Sármellék
LHSN – Szolnok Airport – Szolnok
LHSK (SFK) – Siófok-Kiliti Airport – Ságvár
LHTA (TZR) – Taszár Airport – Taszár
LHTL – Tököl Airport – Tököl
LHUD - Szeged Airport - Szeged


== LI - Italy ==
Also see airport category and list.

LIAF – Foligno Airport – Foligno
LIAP – Preturo Airport – L'Aquila
LIAT – Pontedera Airport – Pontedera, Pisa
LIAU – Capua Airport – Capua
LIBA – Amendola Air Force Base – Foggia
LIBC (CRV) – Crotone Airport (Sant'Anna Airport) – Crotone
LIBD (BRI) – Palese Macchie Airport – Bari
LIBF (FOG) – Gino Lisa Airport – Foggia
LIBG (TAR) – Grottaglie Airport – Taranto
LIBN (LCC) – Lecce Airport (military) – Lecce
LIBP (PSR) – Abruzzo International Airport – Pescara
LIBR (BDS) – Casale Airport – Brindisi
LIBV – Gioia del Colle Air Force Base – Gioia del Colle, Bari
LIBX – Martina Franca Air Force Base – Martina Franca, Taranto
LICA (SUF) – Lamezia Terme International Airport – Lamezia Terme, Catanzaro
LICB (CIY) – Comiso Airport – Comiso
LICC (CTA) – Catania-Fontanarossa Airport (Catania-Fontanarossa Airport) – Catania
LICD (LMP) – Lampedusa Airport – Lampedusa
LICG (PNL) – Pantelleria Airport (military?) – Pantelleria, Trapani
LICJ (PMO) – Palermo International Airport (Punta Raisi Falcone-Borsellino Airport) – Palermo / Punta Raisi
LICP – Boccadifalco Airport – Palermo
LICR (REG) – Reggio Calabria Airport – Reggio Calabria
LICT (TPS) – Vincenzo Florio Airport (Birgi Airport) – Trapani
LICZ (NSY) – Sigonella Airport (military) – Catania
LIDA – Asiago Airport – Asiago, Vicenza
LIDB (BLX) – Belluno Airport – Belluno
LIDE – Reggio Emilia Airport – Reggio Emilia
LIDF – Fano Airport – Fano, Pesaro & Urbino
LIDG – Lugo di Romagna Airport – Lugo di Romagna, Ravenna
LIDR (RAN) – Ravenna Airport – Ravenna
LIDT (ZIA) – G. Caproni Airport (Mattarello Airport) – Trento
LIDU – Carpi Budrione Airport – Carpi
LIEA (AHO) – Fertilia Airport (Alghero Airport) – Alghero, Sassari
LIED (DCI) – Decimomannu Air Force Base – Decimomannu, Cagliari
LIEE (CAG) – Cagliari - Elmas Airport – Cagliari
LIEO (OLB) – Olbia - Costa Smeralda Airport – Olbia
LIER – Fenosu Airport – Oristano
LIET (TTB) – Tortoli - Arbatax Airport – Tortoli
LILE – Cerrione Airport – Biella
LILG – Vergiate Airport – Vergiate, Varese
LILH – Rivanazzano Airport – Voghera, Pavia
LILN (QVA) – Venegono Airport – Varese
LILR – Migliaro Airport – Cremona
LIMA – Aeritalia Airport – Turin (Torino)
LIMB – Bresso Airport – Milan
LIMC (MXP) – Malpensa International Airport – Milan
LIME (BGY) – Orio al Serio International Airport – Bergamo
LIMF (TRN) – Turin International Airport (Torino Caselle Airport) – Turin (Torino)
LIMG (ALL) – Villanova d'Albenga International Airport (C. Panero Airport) – Albenga, Savona
LIMJ (GOA) – Genoa Cristoforo Colombo Airport (Sestri Airport) – Genoa (Genova)
LIML (LIN) – Linate Airport – Milan
LIMN – Cameri Air Force Base – Cameri, Novara
LIMP (PMF) – Parma Airport (G. Verdi Airport) – Parma
LIMS – San Damiano Air Force Base – Piacenza
LIMW (AOT) – Aosta Airport (Corrado Gex Airport) – Aosta
LIMZ (CUF) – Cuneo Levaldigi Airport – Cuneo
LIPA (AVB) – Aviano Air Base – Aviano, Pordenone
LIPB (BZO) – Bolzano Dolomiti Airport – Bolzano, Bolzano-Bozen
LIPC – Cervia Air Force Base – Cervia, Ravenna
LIPD (UDN) – Campoformido Airport (military?) – Campoformido / Udine
LIPE (BLQ) – Bologna Airport (Guglielmo Marconi Airport) – Bologna
LIPF – Ferrara Airport – Ferrara
LIPH (TSF) – Treviso Airport (Sant'Angelo Airport) – Treviso
LIPI – Rivolto Air Force Base – Rivolto / Udine
LIPK (FRL) – Forlì Airport (L. Ridolfi Airport) – Forlì
LIPL – Ghedi Airport (military) – Ghedi, Brescia
LIPM – Modena Marzaglia Airport – Modena
LIPN – Boscomantico Airport – Verona
LIPO (VBS) – Montichiari Airport – Brescia
LIPQ (TRS) – Friuli Venezia Giulia Airport (Trieste Ronchi dei Legionari Airport) – Ronchi dei Legionari / Trieste
LIPR (RMI) – Federico Fellini International Airport – Rimini
LIPS – Istrana Air Force Base – Treviso
LIPT (VIC) – Vicenza Trissino Airport – Vicenza
LIPU – Padova Airport (Gino Allegri Airport) – Padua (Padova)
LIPV – San Nicolo Airport – Venice (Venezia)
LIPX (VRN) – Verona Airport (Villafranca International Airport, Valerio Catullo) – Verona
LIPY (AOI) – Ancona Falconara Airport (Raffaello Sanzio Airport) – Ancona
LIPZ (VCE) – Marco Polo International Airport (Marco Polo Venice Airport) – Venice (Venezia)
LIQL (LCV) – Tassignano Airport – Lucca
LIQS (SAY) – Siena Airport – Siena
LIQW – Luni Airport (military?) – Sarzana, Genoa
LIRA (CIA) – Ciampino Airport (Giovan Battista Pastine Airport) – Rome
LIRC – Centocelle Air Force Base – Centocelle, Rome
LIRE – Pratica di Mare Air Force Base – Pomezia, Rome
LIRF (FCO) – Leonardo da Vinci International Airport (Fiumicino International Airport) – Rome
LIRG – Guidonia Air Force Base – Guidonia Montecelio, Rome
LIRI – Salerno Costa d'Amalfi Airport – Salerno
LIRJ (EBA) – Marina di Campo Airport – Marina di Campo, Elba
LIRL (QLT) – Latina Airport (military?) – Latina
LIRM – Grazzanise Airport (military?) – Caserta
LIRN (NAP) – Naples International Airport (Capodichino Airport) – Naples
LIRP (PSA) – Galileo Galilei Airport (Pisa International Airport) – Pisa
LIRQ (FLR) – Amerigo Vespucci Airport (Florence Airport) – Florence (Firenze)
LIRS (GRS) – Grosseto Airport – Grosseto
LIRU – Rome Urbe Airport – Rome
LIRV – Viterbo Air Force Base / Rome Viterbo Airport – Viterbo
LIRZ (PEG) – San Egidio Airport – Perugia


== LJ - Slovenia ==
Also see airport category and list.

LJAJ – Ajdovščina Airport – Ajdovščina
LJBL – Lesce-Bled Airport – Lesce
LJBO – Bovec Airport – Bovec
LJCE – Cerklje Air Base – Cerklje ob Krki, Brežice
LJCL – Celje Airport – Celje (Levec)
LJLA – Ljubljana ACC-FIR-AFTN Airport – Ljubljana
LJLJ (LJU) – Brnik Airport (Ljubljana Airport) – Ljubljana
LJMB (MBX) – Maribor Airport – Maribor
LJMS – Murska Sobota Airport – Murska Sobota (Rakičan)
LJNM – Novo Mesto-Prečna Airport – Novo Mesto (Prečna)
LJPO – Postojna Airport – Postojna
LJPT – Ptuj Airport – Ptuj (Moškanjci)
LJPZ (POW) – Portorož Airport – Portorož
LJSG – Slovenj Gradec Airport – Slovenj Gradec
LJVE – Velenje Airport – Velenje (Lajše)


== LK - Czech Republic ==
Also see airport category and list.

LKBA – Břeclav Airport – Břeclav
LKBE – Benešov Airport – Benešov
LKBR – Broumov Airport – Broumov
LKBU – Bubovice Airport – Bubovice
LKCB former – Cheb Airport – Cheb
LKCE – Česká Lípa Airport – Česká Lípa
LKCH – Chomutov Airport – Chomutov
LKCM – Medlánky Airport – Medlánky
LKCS – České Budějovice Airport – České Budějovice
LKCT – Chotěboř Airport – Chotěboř
LKDK – Dvůr Králové nad Labem Airport – Dvůr Králové nad Labem
LKHB – Havlíčkův Brod Airport – Havlíčkův Brod
LKHC – Hořice Airport – Hořice
LKHD – Hodkovice nad Mohelkou Airport – Hodkovice nad Mohelkou
LKHN – Hranice Airport – Hranice
LKHO (GTW) – Holešov Airport – Holešov
LKJA – Jaroměř Airport – Jaroměř
LKJC – Jičín Airport – Jičín
LKJH – Jindřichův Hradec Airport – Jindřichův Hradec
LKJI – Jihlava Airport – Jihlava
LKKB – Praha Kbely – Praha
LKKL – Kladno Airport – Kladno
LKKO – Kolín Airport – Kolín
LKKO – Krnov Airport – Krnov
LKKR – Křižanov Airport – Křižanov
LKKT – Klatovy Airport – Klatovy
LKKU (UHE) – Kunovice Airport – Kunovice
LKKV (KLV) – Karlovy Vary International Airport – Karlovy Vary
LKKY – Kyjov Airport – Kyjov
LKLT – Letňany Airport – Letňany
LKMB – Mladá Boleslav Airport – Mladá Boleslav
LKMH – Mnichovo Hradiště Airport – Mnichovo Hradiště
LKMI – Mikulovice Airport – Mikulovice
LKMK – Moravská Třebová Airport – Moravská Třebová
LKMO – Most Airport – Most
LKMR – Mariánské Lázně Airport – Mariánské Lázně
LKMT (OSR) – Ostrava-Mošnov International Airport – Ostrava
LKNM – Nové Město Airport – Nové Město nad Metují
LKOL (OLO) – Olomouc Airport – Olomouc
LKOT – Otrokovice Airfield – Otrokovice
LKPA – Polička Airport – Polička
LKPD (PED) – Pardubice Airport – Pardubice
LKPI – Přibyslav Airport – Přibyslav
LKPL – Letkov Airport – Letkov
LKPM – Příbram Airport – Příbram
LKPN – Podhořany Airport – Podhořany
LKPO (PRV) – Přerov Airport – Přerov
LKPR (PRG) – Ruzyně International Airport – Prague
LKPS – Plasy Airport – Plasy
LKRA – Raná u Loun Airport – Raná u Loun
LKRK – Rakovník Airport – Rakovník
LKRO – Roudnice Airport – Roudnice
LKSA – Staňkov Airport – Staňkov
LKSK – Skuteč Airport – Skuteč
LKSN – Slaný Airport – Slaný
LKSO – Soběslav Airport – Soběslav
LKSR – Strunkovice Airport – Strunkovice
LKST – Strakonice Airport – Strakonice
LKSU – Šumperk Airport – Šumperk
LKSZ – Sazená Airport – Sazená
LKTA – Tábor Airport – Tábor
LKTB (BRQ) – Brno-Tuřany Airport – Brno
LKTC – Točná Airport – Točná
LKTO – Toužim Airport – Toužim
LKUO – Ústí nad Orlicí Airport – Ústí nad Orlicí
LKVL – Vlašim Airport – Vlašim
LKVM – Vysoké Mýto Airport – Vysoké Mýto
LKVO – Vodochody Airport – Vodochody
LKVP – Velké Poříčí Airport – Velké Poříčí
LKVR – Vrchlabí Airport – Vrchlabí
LKVY – Vyškov Airport – Vyškov
LKZA (ZBE) – Zábřeh Airport – Zábřeh
LKZB – Zbraslavice Airport – Zbraslavice


== LL - Israel ==
Also see airport category and list.

LLBG (TLV) – Ben Gurion International Airport – Lod / Tel Aviv
LLBS (BEV) – Be'er Sheva Airport (Teyman Airport) – Beersheba (Be'er Sheva)
LLEK – Tel Nof Israeli Air Force Base – Tel Nof (Tel Nov)
LLES – Ein Shemer Airfield – Ein Shemer (Eyn-Shemer)
LLET (ETH) – Eilat Airport (J. Hozman Airport) – Eilat
LLEY (EIY) – Ein Yahav Airfield – Ein Yahav (Eyn-Yahav)
LLFK – Fiq Airfield – Fiq, Golan Heights
LLHA (HFA) – Haifa International Airport (U. Michaeli Airport) – Haifa
LLHB – Hatzerim Airbase (Hatzerim) – Beersheba (Be'er Sheva)
LLHS – Hatzor Airbase – Hatzor
LLHZ – Herzliya Airport – Herzliya (Herzlia)
LLIB (RPN) – Rosh Pina Airport (Ben Ya'aqov Airport) – Rosh-Pina
LLJR (JRS) – Atarot Airport (Jerusalem International Airport) – Jerusalem (currently closed)
LLKS (KSW) – Qiryat Shemona Airport – Qiryat Shemona (Kiryat-Shmona)
LLMG – Megiddo Airport – Megiddo (Meggido)
LLMR (MIP) – Mitzpe Ramon Airfield – Mitzpe Ramon
LLMZ (MTZ) – Bar Yehuda Airfield – Masada
LLNV – Nevatim Israeli Air Force Base – Nevatim
LLOV (VDA) – Ovda International Airport – Negev
LLRD – Ramat David Israeli Air Force Base – Megiddo
LLRM – Ramon Airbase – Mitzpe Ramon
LLSD (SDV) – Sde Dov Airport (Dov Hoz Airport) – Tel Aviv
LLYT (YOT) – Yotvata Airfield – Yotvata


== LM - Malta ==
Also see airport category and list.

LMML (MLA) – Malta International Airport (Luqa Airport) – Luqa


== LN - Monaco ==
No airports; helicopter service from Côte d'Azur International Airport in Nice, France

LNMC (MCM) – Monaco Heliport – Monte Carlo


== LO - Austria ==
Also see airport category and list.

LOKF - Feldkirchen Airfield - Ossiacher See
LOWG (GRZ) – Graz Airport – Graz
LOWI (INN) – Innsbruck Airport – Innsbruck
LOWK (KLU) – Klagenfurt Airport – Klagenfurt
LOWL (LNZ) – Linz Airport (Blue Danube Airport) – Linz
LOWS (SZG) – Salzburg Airport – Salzburg
LOWW (VIE) – Vienna International Airport – Vienna


== LP - Portugal ==
Also see airport category and list.
Portugal Continental

Planned: Lisbon / Alcochete / Peninsula de SetubalLPAR – Alverca Air Base – Alverca do Ribatejo, Vila Franca de Xira
LPAV – Aveiro - São Jacinto Airport (Aveiro Airport) – Aveiro
LPBG (BGC) – Bragança Airport – Bragança
LPBJ – Beja Air Base – Beja
LPBR (BGZ) – Braga Airport – Palmeira,Braga
LPCH (CHV) – Chaves Airport – Chaves
LPCO (CBP) – Coimbra Airport (Antanhol / Cernache /Coimbra) {Bissaya Barreto Airport} – Coimbra
LPCS – Cascais / Tires Airport, São Domingos da Rana, (Cascais Airport)[Tires,Cascais] – Cascais / Estoril - Sintra Coast / Greater Lisbon
LPCV (COV) – Covilhã Airport – Covilhã / Cova da Beira / Guarda / Beiras / Serra da Estrela
LPEV – Évora Airport – Évora / Alentejo Central
LPFR (FAO) – Faro Airport – Faro / Algarve Int. Faro
LPIN – Espinho Airport – Paramos / Silvalde/Espinho
LPLG - Lagos, AlgarveBarlavento(Portugal)-Brigadeiro Franco Airport Lagos/ Silves / Vila do Bispo area.
LPMC -Macedo de Cavaleiros
LPMF – Monfortinho Airport – Monfortinho, Idanha-a-Nova
LPMI – Mirandela Airport – Mirandela
LPMO – Montargil Airport – Montargil, Ponte de Sor
LPMR – Monte Real Air Base – Monte Real, Leiria
LPMT (PAF) – Montijo Air Base – Montijo
LPMU - Mogadouro Aerodrome - Mogadouro
LPOT – Ota Air Base – Ota, Alenquer
LPOV – Ovar Air Base – Maceda,Ovar
LPPM (PRM) – Portimão Airport – Montes de Alvor /Penina / Alvor, Portimão,Barlavento
LPPR (OPO) – Porto / Oporto - Francisco Sá Carneiro Airport Int. – Pedras Rubras,Moreira,Maia;Greater Porto area:Matosinhos,Vila do Conde,Maia,Grande Porto
LPPT (LIS) – Lisbon / Lisboa,Portela Airport (Lisbon Airport) – Portela,Lisbon / Prior Velho, Loures (Lisbon) Int.
LPPV – Praia Verde Airport – Praia Verde,Altura Castro Marim / Tavira / Sotavento area.
LPSC – Torres Vedras /Santa Cruz Beach Santa Cruz Airport – Praia de Santa Cruz, Torres Vedras
LPSI (SIE) – Sines Airport – Sines /Alentejo Litoral
LPSR – Santarém Airport – Santarém
LPST – Sintra Air Base – Granja do Marquês / Pero Pinheiro, [[[Sintra]]
LPTN – Tancos Air Base – Tancos, Vila Nova da Barquinha, Médio Tejo
LPVL – Maia Airport {Maia Airfield} (Vilar da Luz Airport) – Maia
LPVM – Vilamoura Airport – Vilamoura / Quarteira, Loulé
LPVR (VRL) – Vila Real Airport – Vila Real / Alto Douro
LPVZ (VSE) – Viseu Airport (Gonçalves Lobato Airport) – Lordosa, Viseu (Viséu)


=== Azores ===
LPAZ (SMA) – Santa Maria Airport – Santa Maria Island / Vila do Porto
LPCR (CVU) – Corvo Airport – Corvo Island / Vila do Corvo
LPFL (FLW) – Flores Airport – Flores Island / Santa Cruz das Flores
LPGR (GRW) – Graciosa Airport – Graciosa Island / Santa Cruz da Graciosa
LPHR (HOR) – Horta Airport – Horta, Faial Island
LPLA (TER) – Lajes Air Base Int. – Terceira Island /Praia da Vitoria /Angra area
LPPD (PDL) – Ponta Delgada João Paulo II Airport, formerlyNordela Int. – Ponta Delgada, São Miguel Island
LPPI (PIX) – Pico Airport – Pico Island (Madalena,São Roque,Lajes do Pico)
LPSJ (SJZ) – São Jorge Airport – São Jorge Island /Velas


=== Madeira ===
LPMA (FNC) – Madeira Airport Int. (Funchal Airport) – Funchal, Madeira Island (Santa Cruz) /Funchal area {Madeira Island}
LPPS (PXO) – Porto Santo Airport – Porto Santo Island / Vila Baleira {Porto Santo Island}


== LQ - Bosnia and Herzegovina ==
Also see airport category and list.

LQBI – Bihać Airport – Bihać
LQBK (BNX) – Banja Luka International Airport – Banja Luka
LQBU – Sarajevo Butmir Airport – Sarajevo
LQBZ – Banja Luka Zalužani Airport – Banja Luka
LQCO – Ćoralići Airport – Ćoralići
LQGL – Glamoč Airport – Glamoč
LQJL – Tuzla Jegen Lug Airport – Tuzla
LQKU – Kupres Bajramovići Airport – Kupres
LQLV – Livno Airport – Livno
LQMJ – Mostar Jasenica Airport – Mostar
LQMO (OMO) – Mostar International Airport – Mostar
LQPD – Prijedor Airport – Prijedor
LQSA (SJJ) – Sarajevo International Airport – Sarajevo
LQSV – Sarajevo Military Airport – Sarajevo
LQTG – Tomislavgrad Airport – Tomislavgrad
LQTR – Novi Travnik Airport – Novi Travnik
LQTZ (TZL) – Tuzla International Airport – Tuzla
LQVI – Visoko Airport – Visoko


== LR - Romania ==
Also see airport category and list.

LRAR (ARW) – Arad International Airport – Arad
LRBC (BCM) – Bacău International Airport – Bacău
LRBM (BAY) – Baia Mare Airport – Baia Mare
LRBS (BBU) – Bucharest "Aurel Vlaicu" Vlaicu International Airport – Bucharest
LRCK (CND) – Constanţa "Mihail Kogălniceanu" International Airport – Constanţa
LRCL (CLJ) – Cluj-Napoca International Airport – Cluj-Napoca
LRCS (CSB) – Caransebeş Airport – Reşiţa
LRCV (CRA) – Craiova Airport – Craiova
LRIA (IAS) – Iaşi International Airport – Iaşi
LROD (OMR) – Oradea International Airport – Oradea
LROP (OTP) – Bucharest "Henri Coandǎ" International Airport – Bucharest
LRSB (SBZ) – Sibiu International Airport – Sibiu
LRSM (SUJ) – Satu Mare International Airport – Satu Mare
LRSV (SCV) – Suceava Airport – Suceava
LRTC (TCE) – Tulcea Airport – Tulcea
LRTM (TGM) – Târgu Mureş International Airport – Târgu-Mureş
LRTR (TSR) – Timişoara "Traian Vuia" International Airport – Timişoara


== LS - Switzerland ==
Also see airport category and list.

LSER – Raron Heliport – Raron
LSEZ – Zermatt Heliport – Zermatt
LSGB – Bex Airport – Bex
LSGC (ZHV) – Les Eplatures Airport – La Chaux-de-Fonds
LSGE – Fribourg-Ecuvillens Airfield – Ecuvillens
LSGG (GVA) – Geneva Cointrin International Airport – Geneva
LSGK – Saanen Airport – Saanen
LSGL (QLS) – Lausanne Airport – Lausanne / Blécherette
LSGN (QNC) – Neuchâtel Airport – Neuchâtel
LSGP – La Côte Airport – La Côte
LSGR – Reichenbach Airport – Reichenbach
LSGS (SIR) – Sion Airport – Sion (ICAO code applies to civilian airport)
LSGT – Gruyères Airport – Gruyères
LSGY – Yverdon-les-Bains Airport – Yverdon-les-Bains
LSHC – Collombey-Muraz Heliport – Collombey-Muraz
LSHG – Gampel Heliport – Gampel
LSMA – Alpnach Air Base – Alpnach (military)
LSMD – Dübendorf Air Base – Dübendorf (military)
LSME – Emmen Air Base – Emmen (military)
LSMM – Meiringen Air Base – Meiringen (military)
LSMP – Payerne Air Base – Payerne (military)
LSMS – Sion Air Base – Sion (military)
LSPA – Amlikon Airport – Amlikon
LSPD – Dittingen Airport – Dittingen
LSPF – Schaffhausen Airport – Schaffhausen
LSPG – Kägiswil Airport – Kägiswil
LSPH – Winterthur Airport – Winterthur
LSPK – Hasenstrick Airport – Hasenstrick
LSPL – Langenthal Airport – Langenthal
LSPM – Ambri Airport – Ambri
LSPN – Triengen Airport – Triengen
LSPO – Olten Airport – Olten
LSPV – Wangen-Lachen Airport – Wangen-Lachen
LSTB – Bellechasse Airport – Bellechasse
LSTO – Môtiers Airport – Môtiers
LSTR – Montricher Airport – Montricher
LSTS – St. Stephan Airport – St. Stephan
LSXB – Balzers Heliport – Balzers
LSXG – Gsteigwiler Heliport – Gsteigwiler
LSXI – Interlaken Heliport – Interlaken
LSXK – Benken Heliport – Benken
LSXL – Lauterbrunnen Heliport – Lauterbrunnen
LSXO – Trogen Heliport – Trogen
LSXS – Schindellegi Heliport – Schindellegi
LSXT – Trogen Heliport – Trogen
LSXU – Untervaz Heliport – Untervaz
LSXW – Würenlingen Heliport – Würenlingen
LSXY – Leysin Heliport – Leysin
LSZA (LUG) – Lugano Airport – Lugano / Agno
LSZB (BRN) – Berne Airport – Berne / Belp
LSZC (BXO) – Buochs Airport – Buochs
LSZD (ACO) – Ascona Airport – Ascona
LSZE – Bad Ragaz Airport – Bad Ragaz
LSZF – Birrfeld Airport – Birrfeld
LSZG (ZHI) – Grenchen Airport – Grenchen
LSZH (ZRH) – Zürich Airport (Kloten Airport) – Zürich / Kloten
LSZI – Fricktal-Schupfart Airport – Fricktal-Schupfart
LSZJ – Courtelary Airport – Courtelary
LSZK – Speck-Fehraltorf Airport – Speck-Fehraltorf
LSZL (ZJI) – Locarno Airport – Locarno
LSZN – Hausen am Albis Airport – Hausen am Albis
LSZO – Luzern-Beromünster Airport – Luzern-Beromünster
LSZP – Biel-Kappelen Airport – Biel-Kappelen
LSZR (ACH) – St. Gallen-Altenrhein Airport – St. Gallen / Altenrhein
LSZS (SMV) – Samedan Airport (Engadin Airport) – Samedan
LSZT – Lommis Airport – Lommis
LSZU – Buttwil Airport – Buttwil
LSZV – Sitterdorf Airport – Sitterdorf
LSZW – Thun Airport – Thun
LSZX – Schänis Airport – Schänis
LSZY – Porrentruy Airport – PorrentruyAlso:

LFSB (BSL) – EuroAirport Basel-Mulhouse-Freiburg – Basel (Switzerland), Mulhouse (France) and Freiburg (Germany)


== LT - Turkey ==
Also see airport category and list.

LTAC (ESB) – Ankara Esenboğa International Airport – Ankara
LTAF (ADA) – Adana Şakirpaşa Airport – Adana
LTAI (AYT) – Antalya Airport – Antalya
LTAJ (GZT) – Oğuzeli Airport – Gaziantep
LTAK (HTY) – Hatay Airport – Antakya
LTAL (KFS) – Kastamonu Airport – Kastamonu
LTAN (KYA) – Konya Airport – Konya
LTAR (VAS) – Sivas Airport – Sivas
LTAT (MLX) – Malatya Erhaç Airport – Malatya
LTAU (ASR) – Kayseri Erkilet International Airport – Kayseri
LTAY (DNZ) – Denizli Çardak Airport – Denizli
LTAZ (NAV) – Nevşehir Kapadokya Airport – Nevşehir
LTBA (IST) – Istanbul Atatürk International Airport – Istanbul
LTBH (CKZ) – Çanakkale Airport – Çanakkale
LTBJ (ADB) – İzmir Adnan Menderes Airport – İzmir
LTBO (USQ) - Uşak Airport - Uşak
LTBR (YEI) – Bursa Yenişehir Airport – Bursa
LTBS (DLM) – Dalaman Airport – Muğla
LTBU (TEQ) – Çorlu Airport – Tekirdağ
LTBW (none)– Istanbul Hezarfen Airfield – Istanbul
LTCA (EZS) – Elazığ Airport – Elazığ
LTCC (DIY) – Diyarbakır Airport – Diyarbakır
LTCD (ERC) – Erzincan Airport – Erzincan
LTCE (ERZ) – Erzurum Airport – Erzurum
LTCF (KSY) – Kars Airport – Kars
LTCG (TZX) – Trabzon Airport – Trabzon
LTCH (SFQ) – Şanlıurfa Airport – Şanlıurfa
LTCI (VAN) – Van Ferit Melen Airport – Van
LTCJ (BAL) – Batman Airport – Batman
LTCK (MSR) – Muş Airport – Muş
LTCL (SXZ) – Siirt Airport – Siirt
LTCN (KCM) – Kahramanmaraş Airport – Kahramanmaraş
LTCO (AJI) – Ağrı Airport – Ağrı
LTCP (ADF) – Adıyaman Airport – Adıyaman
LTCR (MQM) – Mardin Airport – Mardin
LTFC (ISE) – Süleyman Demirel Airport – Isparta
LTFD (EDO) – Edremit Körfez Airport – Balıkesir
LTFE (BJV) – Milas-Bodrum Airport – Milas
LTFH (SZF) – Samsun-Çarşamba Airport – Samsun
LTFJ (SAW) – Istanbul Sabiha Gökçen International Airport – Istanbul


== LU - Moldova ==
Also see airport category and list.

LUBL (BZY) – Bălţi Airport – Bălţi
LUBM – Mărculeşti Airport – Mărculeşti
LUCH – Cahul Airport – Cahul
LUCM – Camenca Airport – Camenca
LUKK (KIV) – Chişinău International Airport – Chişinău
LUSR – Soroca Airport – Soroca
LUTG – Tighina Airport – Tighina
LUTR – Tiraspol Airport – Tiraspol


== LV - Areas under the Command of the Palestinian Authority ==
Also see airport category and list.

LVGZ (GZA) – Yasser Arafat International Airport (formerly Gaza International Airport) – Rafah


== LW - Macedonia, Republic of ==
Also see airport category and list.

LWOH (OHD) – Ohrid Airport – Ohrid
LWSK (SKP) – Skopje Airport – Skopje


== LX - Gibraltar ==
Also see airport category and list.

LXGB (GIB) – Gibraltar Airport – Gibraltar


== LY - Serbia and Montenegro ==


=== Serbia ===
Also see airport category and list.

LYBE (BEG) – Belgrade Nikola Tesla International Airport – Belgrade
LYBT (BJY) – Batajnica Airport – Batajnica / Belgrade
LYKV – Kraljevo-Lađevci Airport – Kraljevo
LYNI (INI) – Niš Constantine the Great International Airport – Niš
LYNS (QND) – Novi Sad-Čenej Airport – Novi Sad
LYPR (PRN) – Priština International Airport – Priština
LYTR – Trstenik Airport – Trstenik
LYUZ (UZC) – Užice-Ponikve Airport – Užice
LYVR – Vršac Airport – Vršac
LYZR – Zrenjanin Airport – Zrenjanin


=== Montenegro ===
Also see airport category and list.

LYBR (IVG) – Berane Airport – Berane, Montenegro
LYPJ (TIV) – Golubovci Airbase – Golubovci, Montenegro
LYNK – Kapino Polje Airport – Nikšić, Montenegro
LYPG (TGD) – Podgorica Airport – Podgorica, Montenegro
LYPO – Ćemovsko Polje Airport – Podgorica, Montenegro
LYTV (TIV) – Tivat Airport – Tivat, Montenegro


== LZ - Slovakia ==
Also see airport category and list.

LZIB (BTS) – Milan Rastislav Štefánik Airport (Bratislava Airport) – Bratislava
LZKZ (KSC) – Košice International Airport – Košice
LZME — Martin Airport — Martin
LZPP (PZY) – Piešťany Airport
LZSE – Senica Airport – Senica
LZSL (SLD) – Sliač Airport – Sliač
LZTT (TAT) – Poprad-Tatry Airport – Poprad
LZZI (ILZ) – Žilina Airport – Žilina


== References ==
"ICAO Location Indicators by State" (PDF). International Civil Aviation Organization. 2006-01-12. मूल से 26 सितंबर 2007 को पुरालेखित (PDF). अभिगमन तिथि 14 अप्रैल 2009."संयुक्त राष्ट्र Code for Trade and Transport Locations] [includes IATA codes". UN/LOCODE 2006-2. UNECE. 2007-04-30. मूल से 9 मई 2007 को पुरालेखित. अभिगमन तिथि 14 अप्रैल 2009.