revision: 4796599
title: Ylivieska Airport
url: https://hi.wikipedia.org/wiki/%E0%A4%B5%E0%A4%BF%E0%A4%AE%E0%A4%BE%E0%A4%A8%E0%A4%95%E0%A5%8D%E0%A4%B7%E0%A5%87%E0%A4%A4%E0%A5%8D%E0%A4%B0%E0%A5%8B%E0%A4%82_%E0%A4%95%E0%A5%80_%E0%A4%B8%E0%A5%82%E0%A4%9A%E0%A5%80_ICAO_%E0%A4%95%E0%A5%8B%E0%A4%A1_%E0%A4%85%E0%A4%A8%E0%A5%81%E0%A4%B8%E0%A4%BE%E0%A4%B0:_E


---

Format of entries is:

ICAO (IATA) – Airport Name – Airport Location


== EB - Belgium ==
Also see airport category and list.

EBAW (ANR) – Antwerp International Airport – Antwerp / Deurne
EBBE – Beauvechain Air Base – Beauvechain
EBBL – Kleine Brogel Air Base – Kleine Brogel
EBBR (BRU) – Brussels Airport – Brussels / Zaventem  
EBBT – Brasschaat AB – Brasschaat
EBBX – Jehonville Air Base – Bertrix
EBCI (CRL) – Brussels South Charleroi Airport – Charleroi
EBCF – Cerfontaine AB – Cerfontaine
EBCV – Chievres AB (U.S. Air Force) – Chievres
EBFN – Koksijde AB – Koksijde
EBFS – Florennes Air Base – Florennes
EBGB – Grimbergen Airfield – Grimbergen
EBHN – Hoevenen Airport – Hoevenen
EBKH – Balen-Keiheuvel Airport – Balen-Keiheuvel
EBKT (KJK) – Kortrijk-Wevelgem International Airport – Kortrijk / Wevelgem
EBLG (LGG) – Liege Airport – Liège
EBLE – Leopoldsburg – Leopoldsburg
EBMB – Melsbroek Air Base – Brussels
EBNM – Suarlee Airport – Namur
EBOS (OST) – Ostend-Bruges International Airport – Ostend
EBSG – Saint-Ghislain AB – Saint-Ghislain
EBSH – Saint-Hubert Airport – Saint-Hubert
EBSL – Zutendaal AB – Zutendaal
EBSP – La Sauveniere Airport – Spa
EBST – Sint-Truiden AB – Sint-Truiden
EBSU – Saint-Hubert AB – Saint-Hubert
EBTN – Goetsenhoven AB – Goetsenhoven
EBTX – Verviers Airport – Theux
EBTY – Maubray Airport – Tournai
EBUL – Ursel AB – Ursel
EBWE – Weelde Air Base – Weelde
EBZH (QHA) – Hasselt Airport – Hasselt
EBZR – Oostmalle AB – Zoersel
EBZW – Zwartberg Airport – Genk


== ED ET - Germany ==
Also see airport category and list.


=== ED - Civil airports ===
EDAC (AOC) – Leipzig-Altenburg Airport – Altenburg/Leipzig
EDAD – Dessau Airport – Dessau
EDAX – Lärz/Rechlin Airport – Rechlin
EDCD (CBU) – Cottbus-Drewitz Airport – Cottbus
EDCI – Klix Airfield - Bautzen
EDDB (SXF) – Berlin-Schönefeld International Airport (to be expanded and renamed Berlin Brandenburg International Airport in 2011) – Berlin
EDDC (DRS) – Dresden Klotzsche Airport – Dresden
EDDE (ERF) – Erfurt Airport – Erfurt
EDDF (FRA) – Frankfurt International Airport – Frankfurt am Main
EDDG (FMO) – Münster Osnabrück International Airport – Greven
EDDH (HAM) – Hamburg Airport – Hamburg
EDDI (THF) – Tempelhof International Airport (closed in 2008) – Berlin
EDDK (CGN) – Cologne Bonn Airport – Cologne/Bonn
EDDL (DUS) – Düsseldorf International Airport – Düsseldorf
EDDM (MUC) – Munich International Airport (Franz Josef Strauß International Airport) – Munich
EDDN (NUE) – Nuremberg Airport – Nuremberg
EDDP (LEJ) – Leipzig/Halle Airport – Leipzig/Halle
EDDR (SCN) – Saarbrücken Airport – Saarbrücken
EDDS (STR) – Stuttgart Echterdingen Airport – Stuttgart
EDDT (TXL) – Tegel International Airport (closing in 2011) – Berlin
EDDV (HAJ) – Hanover/Langenhagen International Airport – Hanover
EDDW (BRE) – Bremen Airport – Bremen
EDFE (QEF) – Frankfurt Egelsbach Airport – Hesse
EDFH (HHN) – Frankfurt-Hahn Airport – Rhineland-Palatinate
EDFM (MHG) – Mannheim City Airport – Mannheim
EDFZ (QMZ) – Mainz-Finthen – Mainz
EDGS (SGE) – Siegerland Airport – Burbach
EDHE – Uetersen Airport – Heist
EDHI (XFW) – Hamburg Finkenwerder Airport – Hamburg
EDHK (KEL) – Kiel Holtenau Airport – Kiel
EDHL (LBC) – Lübeck Airport – Lübeck
EDIU (HDB) – Heidelberg Airport – Heidelberg
EDJA – Allgäu Airport – Memmingen
EDKA (AAH) – Aachen-Merzbrück Airport – Aachen
EDKB – Bonn-Hangelar Airport – Sankt Augustin
EDKL – Leverkusen Airport – Leverkusen
EDKV – Dahlemer Binz Airport – Dahlem
EDLC – Kamp-Lintfort – Wesel
EDLG – Goch-Asperden Airport – Goch
EDLK (QKF) – Krefeld-Egelsberg Airport – Krefeld
EDLN (MGL) – Düsseldorf-Mönchengladbach Airport – Mönchengladbach
EDLP (PAD) – Paderborn Lippstadt Airport – Paderborn / Lippstadt
EDLV (NRN) – Weeze Airport (formerly Niederrhein Airport) – Weeze
EDLW (DTM) – Dortmund Airport – Dortmund
EDNY (FDH) – Bodensee Airport – Friedrichshafen
EDMA (AGB) – Augsburg Airport – Augsburg
EDMQ – Donauwörth Airport – Genderkingen
EDOJ – Lüsse – Lüsse
EDOP – Schwerin-Parchim Airport – Parchim
EDQD (BYU) – Bindlacher Berg Airport (Bayreuth Airport) – Bayreuth
EDQE - Burg Feuerstein
EDQM (HOQ) – Hof-Plauen Airfield – Hof/Plauen
EDRB (BBJ) – Bitburg Airport – Bitburg
EDRI – Linkenheim Airport – Linkenheim-Hochstetten
EDRK – Koblenz Winningen – Winningen, Mosel
EDRZ (ZQW) – Zweibrücken Airport – Zweibrücken
EDSB (FKB) – Baden Airpark – Baden-Baden / Karlsruhe
EDTL (LHA) - Black Forest Airport - Lahr
EDTF - Freiburg im Breisgau Airport - Freiburg i. Br.
EDTQ - Pattonville Airfield - Pattonville
EDTY – Adolf Würth Airport – Schwäbisch Hall
EDTX – Weckrieden – Schwäbisch Hall
EDVK (KSF) – Kassel Calden Airport – Kassel
EDWB (BRV) – Bremerhaven Airport – Bremerhaven
EDXH (HGL) – Heligoland Airport – Heligoland
EDXM – St. Michaelisdonn – St. Michaelisdonn
EDXW (GWT) – Sylt Airport – Westerland, Sylt


=== ET - Military airports ===
ETAD (SPM) – Spangdahlem Air Base – Spangdahlem
ETAR (RMS) – Ramstein Air Base – Ramstein
ETHA - Altenstadt Army Base - Altenstadt
ETHB - Bückeburg Army Base - Bückeburg
ETHC (ZCN) - Celle Army Base - Celle
ETHE (ZPQ) - Rheine Air Base - Rheine
ETHF (FRZ) - Fritzlar Army Base - Fritzlar
ETHL – Laupheim Army Base – Laupheim
ETHM – Mendig Army Base – Niedermendig
ETHS – Fassberg Army Base – Fassberg
ETMN (FCN) – Nordholz Naval Air Station – Nordholz
ETND – Diepholz Airforce Base – Diepholz
ETNG (GKE) – NATO Air Base Geilenkirchen – Geilenkirchen
ETNH – Hohn Airforce Base – Hohn
ETNJ – Jever Airforce Base – Schortens
ETNL (RLG) – Rostock Laage Airport – Rostock
ETNN – Nörvenich Airforce Base – Nörvenich
ETNS (WBG) – Schleswig Airforce Base – Schleswig
ETNT – Wittmundhafen Airbase – Wittmund
ETNW – Wunstorf Airbase – Wunstorf
ETOR – Coleman Army Airfield – Mannheim
ETOU – Wiesbaden Army Airfield – Wiesbaden
ETSA – Landsberg-Lech Air Base – Landsberg am Lech
ETSB – Büchel Airforce Base – Büchel / Cochem
ETSE – Erding Air Base – Erding
ETSF – Fürstenfeldbruck Air Base – Fürstenfeldbruck
ETSH – Holzdorf Airforce Base – Jessen (Elster)
ETSI (IGS) – Ingolstadt Manching Airport – Ingolstadt
ETSL – Lechfeld Airforce Base – Lechfeld
ETUL (LRC) – RAF Laarbruch – Weeze (closed in 1999, now Weeze Airport, NRN/EDLV)
ETUO (GUT) – RAF Gütersloh – Gütersloh (closed in 1993)
ETUR (BGN) – RAF Brüggen – Brüggen (closed in 2001)
ETWM – Meppen Air Base – Meppen


== EE - Estonia ==
Also see airport category and list.

EECL - Linnahall Heliport - Tallinn
EEEI – Ämari Airport – Ämari
EEKA (KDL) – Kärdla Airport – Kärdla, Hiiumaa
EEKE (URE) – Kuressaare Airport – Kuressaare, Saaremaa
EEKU – Kihnu Airfield – Kihnu
EENI – Nurmsi Airfield – Nurmsi
EENA – Narva Airfield – Narva
EEPU (EPU) – Pärnu Airport – Pärnu
EERA – Rapla Airfield – Rapla
EERI – Ridali Airfield – Ridali
EERU – Ruhnu Airfield – Ruhnu
EETA – Tapa Airfield – Tapa
EETN (TLL) – Tallinn Airport – Tallinn
EETU (TAY) – Tartu Airport – Tartu
EEVI – Viljandi Airfield – Viljandi


== EF - Finland ==
Also see airport category and list.

EFAH – Ahmosuo Airport – Ahmosuo
EFAL – Alavus Airport – Alavus
EFET (ENF) – Enontekiö Airport – Enontekiö
EFEU – Eura Airport – Eura
EFFO – Forssa Airport – Forssa
EFHA (KEV) – Halli Airport – Kuorevesi
EFHF (HEM) – Helsinki-Malmi Airport – Helsinki
EFHK (HEL) – Helsinki-Vantaa Airport – Vantaa
EFHM – Hämeenkyrö Airport – Hämeenkyrö
EFHN – Hanko Airport (Hangö Airport) – Hanko (Hangö)
EFHV (HYV) – Hyvinkää Airport – Hyvinkää
EFIK – Kiikala Airport – Kiikala
EFIL (SJY) – Seinäjoki Airport – Seinäjoki / Ilmajoki
EFIM – Immola Airport – Immola
EFIT (KTQ) – Kitee Airport – Kitee
EFIV (IVL) – Ivalo Airport – Ivalo / Inari
EFJM – Jämijärvi Airport – Jämijärvi
EFJO (JOE) – Joensuu Airport – Joensuu / Liperi
EFJY (JYV) – Jyväskylä Airport – Jyväskylän maalaiskunta
EFKA (KAU) – Kauhava Airport – Kauhava
EFKE (KEM) – Kemi-Tornio Airport – Kemi / Tornio
EFKI (KAJ) – Kajaani Airport – Kajaani
EFKJ (KHJ) – Kauhajoki Airport – Kauhajoki
EFKK (KOK) – Kronoby Airport (Kokkola and Jakobstad Airport) – Kronoby / Kokkola / Jakobstad
EFKM – Kemijärvi Airport – Kemijärvi
EFKO – Kalajoki Airport – Kalajoki
EFKS (KAO) – Kuusamo Airport – Kuusamo
EFKT (KTT) – Kittilä Airport – Kittilä
EFKU (KUO) – Kuopio Airport – Kuopio / Siilinjärvi
EFKV – Kivijärvi Airport – Kivijärvi
EFKY – Kymi Airport – Kymi
EFLA – Vesivehmaa Airport – Lahti
EFLP (LPP) – Lappeenranta Airport – Lappeenranta
EFMA (MHQ) – Mariehamn Airport – Mariehamn
EFME – Menkijärvi Airport – Menkijärvi
EFMI (MIK) – Mikkeli Airport – Mikkeli
EFNU – Nummela Airport – Nummela
EFOU (OUL) – Oulu Airport – Oulunsalo
EFPI – Piikajärvi Airport – Piikajärvi
EFPK – Pieksämäki Airport – Pieksämäki
EFPO (POR) – Pori Airport – Pori
EFPU – Pudasjärvi Airport – Pudasjärvi
EFPY – Pyhäsalmi Airport – Pyhäsalmi
EFRH – Pattijoki Airport – Raahe
EFRN – Rantasalmi Airport – Rantasalmi
EFRO (RVN) – Rovaniemi Airport – Rovaniemi  
EFRU – Ranua Airport – Ranua
EFRV – Kiuruvesi Airport – Kiuruvesi
EFRY – Räyskälä Airport – Räyskälä
EFSA (SVL) – Savonlinna Airport – Savonlinna
EFSE – Selänpää Airport – Selänpää
EFSI (SJY) – Seinajoki Airport – Seinajoki
EFSO (SOT) – Sodankylä Airport – Sodankylä
EFTP (TMP) – Tampere-Pirkkala Airport – Tampere / Pirkkala
EFTS – Teisko Airport – Teisko
EFTU (TKU) – Turku Airport – Turku
EFUT (UTI) – Utti Airport – Utti / Valkeala
EFVA (VAA) – Vaasa Airport – Vaasa
EFVR (VRK) – Varkaus Airport – Varkaus / Joroinen
EFYL (YLI) – Ylivieska Airport – Ylivieska


== EG - United Kingdom (and British Crown dependencies) ==
Also see airport category and list.
Other categories: Airports in England, Airports in Northern Ireland, Airports in Scotland, Airports in Wales

EGAA (BFS) – Belfast International Airport – Belfast, Northern Ireland
EGAB (ENK) – Enniskillen/St Angelo Airport – Enniskillen, Northern Ireland
EGAC (BHD) – George Best Belfast City Airport – Belfast, Northern Ireland
EGAD – Newtownards Airport – Newtownards, Northern Ireland
EGAE (LDY) – City of Derry Airport – Derry, Northern Ireland
EGBB (BHX) – Birmingham International Airport – Birmingham, England
EGBC – Cheltenham Racecourse Heliport – Cheltenham Racecourse, England
EGBD – Derby Airfield – Derby, England
EGBE (CVT) – Coventry Airport – Coventry, England
EGBG – Leicester Airport – Leicester, England
EGBJ (GLO) – Gloucestershire Airport – Staverton, England
EGBK (ORM) – Sywell Aerodrome – Northampton, England
EGBM – Tatenhill Airfield – Tatenhill, England
EGBN (NQT) – Nottingham Airport – Nottingham, England
EGBO – Wolverhampton Airport – Wolverhampton, England
EGBP – Kemble Airport – Kemble, England
EGBS – Shobdon Aerodrome – Leominster, England
EGBT – Turweston Aerodrome – Turweston, England
EGBV – Silverstone Heliport – Silverstone, England
EGBW – Wellesbourne Mountford Airfield – Wellesbourne, England
EGCB – City Airport Manchester – Manchester, England
EGCC (MAN) – Manchester Airport – Manchester, England
EGCD – Woodford Aerodrome – Stockport, England
EGCF – Sandtoft Airfield – Scunthorpe, England
EGCG – Strubby Airfield – Strubby, England
EGCJ – Sherburn-in-Elmet Airfield – Sherburn-in-Elmet, England
EGCK – Caernarfon Airport – Caernarfon, Wales
EGCL – Fenland Airfield – Spalding, England
EGCN (DSA) – Robin Hood Airport Doncaster Sheffield – South Yorkshire, England
EGCO – Southport Birkdale Sands Airport – Southport, England
EGCR - Croydon Airport (Closed 30 सितंबर 1959) - London, England
EGCS – Sturgate Airfield – Lincoln, England
EGCV – Sleap Airfield – Shrewsbury, England
EGCW – Welshpool Airport – Welshpool, Wales
EGDC – Royal Marines Base Chivenor – Braunton, England
EGDG (NQY) – Newquay Cornwall International Airport / RAF St. Mawgan – Newquay, England
EGDJ (UPV) – Upavon Airfield – Upavon, England
EGDL (LYE) – RAF Lyneham – Wiltshire, England
EGDM – MoD Boscombe Down – Amesbury, England
EGDN – Airfield Camp Netheravon – Netheravon, England
EGDO – RNAS Predannack – Mullion, England
EGDP – RNAS Portland Heliport – Portland Harbour, England
EGDR – RNAS Culdrose – Helston, England
EGDS – Salisbury Plain Airport – Bulford, England
EGDT – Wroughton Airport – Wroughton, England
EGDV – Hullavington Airport – Hullavington, England
EGDW – RNAS Merryfield – Yeovil, England
EGDX (DGX) – MoD Saint Athan – St Athan, Wales
EGDY (YEO) – RNAS Yeovilton – Yeovil, England
EGEA - Aberdeen (Culter Helipad) - Aberdeen, Scotland
EGEC (CAL) – Campbeltown Airport – Campbeltown, Scotland
EGED (EOI) – Eday Airport – Eday, Scotland
EGEF (FIE) – Fair Isle Airport – Fair Isle, Scotland
EGEH (WHS) – Whalsay Airport – Whalsay, Scotland
EGEN (NRL) – North Ronaldsay Airport – North Ronaldsay, Scotland
EGEO (OBN) – Oban Airport – Oban, Scotland
EGEP (PPW) – Papa Westray Airport – Papa Westray, Scotland
EGER (SOY) – Stronsay Airport – Stronsay, Scotland
EGES (NDY) – Sanday Airport – Sanday, Scotland
EGET (LWK) – Tingwall Airport – Lerwick, Scotland
EGEW (WRY) – Westray Airport – Westray, Scotland
EGFA – Aberporth Airport – Cardigan, Wales
EGFC – Cardiff Heliport – Cardiff, Wales
EGFE (HAW) – Haverfordwest Aerodrome – Haverfordwest, Wales
EGFF (CWL) – Cardiff International Airport – Cardiff, Wales
EGFH (SWS) – Swansea Airport – Swansea, Wales
EGFP – Pembrey Airport – Pembrey, Wales
EGGD (BRS) – Bristol International Airport – Bristol, England
EGGP (LPL) – Liverpool John Lennon Airport – Liverpool, England
EGGW (LTN) – London Luton Airport – London, England
EGHA – Compton Abbas Airfield – Shaftesbury, England
EGHB – Maypole Airfield – Maypole (Hoath), England
EGHC (LEQ) – Land's End Airport – St Just in Penwith, England
EGHD (PLH) – Plymouth City Airport – Plymouth, England
EGHE (ISC) – St. Mary's Airport – St. Mary's, England
EGHG – Yeovil/Westland Airport – Yeovil, England
EGHH (BOH) – Bournemouth Airport – Bournemouth, England
EGHI (SOU) – Southampton Airport – Southampton, England
EGHJ (BBP) – Bembridge Airport – Sandown, England
EGHK – Penzance Heliport – Penzance, England
EGHL (QLA) – Lasham Airfield – Basingstoke, England
EGHN – Isle of Wight/Sandown Airport – Sandown, England
EGHO – Thruxton Aerodrome – Andover, England
EGHP – Popham Airfield – Popham, England
EGHS – Henstridge Airfield – Henstridge, England
EGHT – Tresco Heliport – Tresco, England
EGHU – Eaglescott Airfield – Great Torrington, England
EGHY – Truro Aerodrome – Truro, England
EGJA (ACI) – Alderney Airport – Alderney, Channel Islands
EGJB (GCI) – Guernsey Airport – Guernsey, Channel Islands
EGJJ (JER) – Jersey Airport & Aviation Beauport – Jersey, Channel Islands
EGKA (ESH) – Shoreham Airport – Shoreham-by-Sea, England
EGKB (BQH) – London Biggin Hill Airport – London, England
EGKE – Challock Airport – Challock, England
EGKG – Goodwood Racecourse Heliport – Goodwood Racecourse, England
EGKH – Lashenden/Headcorn Airport – Maidstone, England
EGKK (LGW) – London Gatwick Airport – London, England
EGKR (KRH) – Redhill Aerodrome – Redhill, England
EGLA – Bodmin Airfield – Bodmin, England
EGLC (LCY) – London City Airport – London, England
EGLD – Denham Aerodrome – Gerrards Cross, England
EGLF (FAB) – Farnborough Airfield – Farnborough, England
EGLG – Panshanger Airport – Hertford, England
EGLJ – Chalgrove Airfield – Oxford, England
EGLK (BBS) – Blackbushe Airport – Camberley, England
EGLL (LHR) – London Heathrow Airport – London, England
EGLM – White Waltham Airfield – White Waltham, England
EGLS – Old Sarum Airfield – Salisbury, England
EGLT – Ascot Racecourse Heliport – Ascot Racecourse, England
EGLW – London Heliport – London, England
EGMA – Fowlmere Airport – Cambridge, England
EGMC (SEN) – London Southend Airport – Southend-on-Sea, England
EGMD (LYX) – London Ashford Airport – Lydd, England
EGMH (MSE) – Kent International Airport – Canterbury, England
EGMJ – Little Gransden Airfield – St Neots, England
EGMK - Lympne Airport - Lympne, England
EGML – Damyns Hall Aerodrome – Upminster, England
EGMT - Thurrock Aerodrome - Thurrock, England
EGNA – Hucknall Airfield – Nottingham, England
EGNB – Brough Aerodrome – Brough, England
EGNC (CAX) – Carlisle Airport – Carlisle, England
EGNE – Gamston Airport – Retford, England
EGNF – Netherthorpe Airfield – Worksop, England
EGNH (BLK) – Blackpool International Airport – Blackpool, England
EGNJ (HUY) – Humberside Airport – Kingston upon Hull, England
EGNL (BWF) – Barrow/Walney Island Airfield – Barrow-in-Furness, England
EGNM (LBA) – Leeds Bradford International Airport – West Yorkshire, England
EGNO – Warton Aerodrome – Preston, England
EGNR (CEG) – Hawarden Airport – Chester, England
EGNS (IOM) – Isle of Man Airport – Isle of Man
EGNT (NCL) – Newcastle Airport – Newcastle upon Tyne, England
EGNU – Full Sutton Airfield – York, England
EGNV (MME) – Durham Tees Valley Airport – Tees Valley, England
EGNW – Wickenby Aerodrome – Lincoln, England
EGNX (EMA) – Nottingham East Midlands Airport – East Midlands, England
EGNY – Beverley/Linley Hill Airfield – Beverley, England
EGOD – Llanbedr Airport – Llanbedr, Wales
EGOE – RAF Ternhill – Ternhill, England
EGOQ – RAF Mona – Anglesey, Wales
EGOS – RAF Shawbury – Shawbury, England
EGOV – RAF Valley/Anglesey Airport – Anglesey, Wales
EGOW – RAF Woodvale – Formby, England
EGPA (KOI) – Kirkwall Airport – Kirkwall, Scotland
EGPB (LSI) – Sumburgh Airport – Shetland Islands, Scotland
EGPC (WIC) – Wick Airport – Wick, Scotland
EGPD (ABZ) – Aberdeen Airport – Aberdeen, Scotland
EGPE (INV) – Inverness Airport – Inverness, Scotland
EGPF (GLA) – Glasgow International Airport – Glasgow, Scotland
EGPG – Cumbernauld Airport – Cumbernauld, Scotland
EGPH (EDI) – Edinburgh Airport – Edinburgh, Scotland
EGPI (ILY) – Islay Airport – Islay, Scotland
EGPJ – Fife Airport – Glenrothes, Scotland
EGPK (PIK) – Glasgow Prestwick International Airport – Glasgow, Scotland
EGPL (BEB) – Benbecula Airport – Benbecula, Scotland
EGPM (SCS) – Scatsta Airport – Lerwick, Scotland
EGPN (DND) – Dundee Airport – Dundee, Scotland
EGPO (SYY) – Stornoway Airport – Stornoway, Scotland
EGPR (BRR) – Barra Airport – Barra, Scotland
EGPT (PSL) – Perth Airport (Scotland) – Perth, Scotland
EGPU (TRE) – Tiree Airport – Tiree, Scotland
EGQK (FSS) – RAF Kinloss – Kinloss, Scotland
EGQL (ADX) – RAF Leuchars – Leuchars, Scotland
EGQM – RAF Boulmer – Alnwick, England
EGQS (LMO) – RAF Lossiemouth – Lossiemouth, Scotland
EGSA – Shipdham Airport – Shipdham, England
EGSB – Bedford Castle Mill Airport – Bedford, England
EGSC (CBG) – Cambridge Airport – Cambridge, England
EGSD – Great Yarmouth - North Denes Airport – Great Yarmouth, England
EGSF – Peterborough Business Airport – Peterborough, England
EGSG – Stapleford Aerodrome – Romford, England
EGSH (NWI) – Norwich International Airport – Norwich, England
EGSJ – Seething Airfield – Norwich, England
EGSK – Hethel Airport – Hethel, England
EGSL – Andrewsfield Airport – Braintree, England
EGSM – Beccles Airport – Beccles, England
EGSN – Bourn Airport – Cambridge, England
EGSO – Crowfield Airfield – Ipswich, England
EGSP – Peterborough/Sibson Airport – Peterborough, England
EGSQ – Clacton Airport – Clacton-on-Sea, England
EGSR – Earls Colne Airfield – Halstead, England
EGSS (STN) – London Stansted Airport – London, England
EGST – Elmsett Airport – Ipswich, England
EGSU (QFO) – Duxford – Cambridge, England
EGSV – Old Buckenham Airport – Norwich, England
EGSX – North Weald Airfield – North Weald, England
EGSY (SZE) – Sheffield City Airport – Sheffield, England
EGTB – Wycombe Air Park/Booker Airport – High Wycombe, England
EGTC – Cranfield Airport – Cranfield, England
EGTD – Dunsfold Aerodrome – Dunsfold, England
EGTE (EXT) – Exeter International Airport – Exeter, England
EGTF – Fairoaks Airport – Chobham, England
EGTG (FZO) – Bristol Filton Airport – Filton, England
EGTK (OXF) – Oxford Airport – Oxford, England
EGTN Enstone Airfield - Enstone, England
EGTO (RCS) – Rochester Airport, England – Rochester, England
EGTP – Perranporth Airfield – Perranporth, England
EGTR – Elstree Airfield – Watford, England
EGTU – Dunkeswell Aerodrome – Honiton, England
EGTW – Oaksey Park Airport – Oaksey, England
EGUB – RAF Benson – Benson, England
EGUD (ABB) – RAF Abingdon – Abingdon, England
EGUL (LKZ) – RAF Lakenheath – Lakenheath, England
EGUN (MHZ) – RAF Mildenhall – Mildenhall, England
EGUO – Colerne Airfield – Colerne, England
EGUW – RAF Wattisham – Stowmarket, England
EGUY (QUY) – RAF Wyton – St Ives, England
EGVA (FFD) – RAF Fairford – Fairford, England
EGVN (BZZ) – RAF Brize Norton – Brize Norton, England
EGVO (ODH) – RAF Odiham – Odiham, England
EGVP – AAC Middle Wallop Airfield – Andover, England
EGWC – RAF Cosford – Albrighton, England
EGWE – RAF Henlow – Henlow, England
EGWN – RAF Halton – Halton, England
EGWU (NHT) – RAF Northolt – Ruislip, England
EGXC (QCY) – RAF Coningsby – Coningsby, England
EGXD – RAF Dishforth – North Yorkshire, England
EGXE – RAF Leeming – Leeming Bar, England
EGXG – RAF Church Fenton – Church Fenton, England
EGXH (BEQ) – RAF Honington – Thetford, England
EGXP (SQZ) – RAF Scampton – Scampton, England
EGXT – RAF Wittering – Stamford, England
EGXU (HRT) – RAF Linton-on-Ouse – Linton-on-Ouse, England
EGXW (WTN) – RAF Waddington – Waddington, England
EGXY – RAF Syerston – Newark-on-Trent, England
EGXZ – RAF Topcliffe – Topcliffe, England
EGYC (CLF) – RAF Coltishall – Norwich, England
EGYD – RAF Cranwell – Cranwell, England
EGYE – RAF Barkston Heath – Grantham, England
EGYM (MRH) – RAF Marham – Marham, England
EGYP (MPN) – RAF Mount Pleasant – Falkland Islands (note: not in SF.. series)


== EH - Netherlands ==
Also see airport category and list.

EHAM (AMS) – Amsterdam Schiphol Airport – Haarlemmermeer, near Amsterdam
EHBD – Budel Airport – Weert
EHDB – KNMI – De Bilt
EHBK (MST) – Maastricht Aachen Airport – Maastricht
EHDL – Deelen Airbase – Deelen
EHDP – De Peel Airport – Venraij
EHDR – Drachten Airfield – Drachten
EHEH (EIN) – Eindhoven Airport – Eindhoven
EHGG (GRQ) – Groningen Airport Eelde – Eelde
EHGR (GLZ) – Gilze-Rijen Airbase – Gilze and Rijen
EHHO – Hoogeveen Airfield – Hoogeveen
EHHV – Hilversum Airport – Hilversum
EHKD – De Kooy – De Kooy
EHVK – Volkel Airbase – Uden
EHLE (LEY) – Lelystad Airport – Lelystad
EHLW – Leeuwarden Air Base – Leeuwarden
EHMC – Nieuw-Millingen – Nieuw-Millingen
EHMZ – Midden-Zeeland – Middelburg, Zeeland
EHOW – Oostwold Airport – Scheemda
EHRD (RTM) – Rotterdam Airport – Rotterdam
EHSB (SSB) – Soesterberg Air Base – Soesterberg
EHSE – Seppe Airport – Hoeven
EHST – Stadskanaal Airfield – Stadskanaal
EHTE – Teuge International Airport – Deventer
EHTL – Terlet Airfield – Terlet
EHTW (ENS) – Enschede Airport Twente – Enschede
EHTX – Texel International Airport – Texel
EHVB – Valkenburg Airbase – Valkenburg
EHWO (WOE) – Woensdrecht Air Base – Woensdrecht


== EI - Ireland ==
Also see airport category and list.

EIAB – Abbeyshrule Aerodrome – Abbeyshrule, County Longford
EIBN (BYT) – Bantry Aerodrome – Bantry, County Cork
EIBR – Birr Aerodrome – Birr, County Offaly
EICA (NNR) – Connemara Regional Airport – Inverin, Connemara
EICK (ORK) – Cork International Airport – Cork
EICL – Clonbullogue Aerodrome – Clonbullogue, County Offaly
EICM (GWY) – Galway Airport – Carnmore, County Galway
EICN – Coonagh Airport – Limerick, County Limerick
EIDL (CFN) – Donegal Airport – Carrickfinn, County Donegal
EIDW (DUB) – Dublin International Airport – Dublin
EIIM (IOR) – Inishmore Aerodrome (Kilronan Airport) – Kilronan, County Galway
EIKL (KKY) – Kilkenny Airport – Kilkenny, County Kilkenny
EIKN (NOC) – Knock International Airport – Knock, County Mayo
EIKY (KIR) – Kerry Airport (Farranfore Airport) – Farranfore, County Kerry
EIME – Casement Aerodrome – Baldonnel
EIMG – Moneygall Aerodrome – Moneygall, County Offaly
EIMY – Moyne Aerodrome – Thurles, County Tipperary
EINN (SNN) – Shannon Airport – Shannon, County Clare
EISG (SXL) – Sligo Airport – Strandhill, near Sligo
EIWF (WAT) – Waterford Airport – Waterford
EIWT (WST) – Weston Airport – Leixlip, County Kildare


== EK - Denmark and the Faroe Islands ==


=== Denmark ===
Also see airport category and list.

EKAH (AAR) – Aarhus Airport – Tirstrup near Aarhus
EKBI (BLL) – Billund Airport – Billund
EKCH (CPH) – Copenhagen Airport – Kastrup near Copenhagen
EKEB (EBJ) – Esbjerg Airport – Esbjerg
EKHG – Herning Airport – Herning
EKKA (KRP) – Karup Airport – Karup
EKMB (MRW) – Lolland Airport – Lolland Falster Maribo
EKOD (ODE) – Odense Airport – Odense
EKRK (RKE) – Roskilde Airport – Tune near Roskilde
EKRN (RNN) – Bornholm Airport – Rønne
EKSB (SGD) – Sønderborg Airport – Sønderborg
EKSN (KSN) – Sindal Airport – Sindal
EKSP (SKS) – Skrydstrup Airport – Vojens
EKSV (SQW) – Skive Airport –Skive
EKTS (TED) – Thisted Airport – Thisted
EKVJ (STA) – Stauning Vestjylland Airport – Skjern
EKYT (AAL) – Aalborg Airport – Aalborg
EKVD (VDP) – Vamdrup Airport – Kolding


=== Faroe Islands ===
Also see airport category and list.

EKVG (FAE) – Vagar Airport – Faroe Islands
EKFA Froðba Heliport – Faroe Islands
EKKV Klaksvík Heliport – Faroe Islands
EKMS Mykines Heliport – Faroe Islands
EKSY Skúvoy Heliport – Faroe Islands
EKSR Stóra Dímun Heliport – Faroe Islands
EKSO Svínoy Heliport – Faroe Islands
EKTB Tórshavn/Bodanes Heliport – Faroe Islands


== EL - Luxembourg ==
Also see airport category and list.

ELLX (LUX) – Luxembourg International Airport – Luxembourg
ELNT – Airfield Noertrange – Luxembourg


== EN - Norway ==
Also see airport category and list.

ENAL (AES) – Ålesund Airport, Vigra – Ålesund, Møre og Romsdal
ENAN (ANX) – Andøya Airport, Andenes – Andenes, Nordland
ENAS – Ny-Ålesund Airport, Hamnerabben – Ny-Ålesund, Svalbard
ENAT (ALF) – Alta Airport – Alta, Finnmark
ENBJ – Bear Island (Bjørnøya), Arctic
ENBL (FDE) – Førde Airport, Bringeland – Førde, Sogn og Fjordane
ENBM – Voss Airport, Bømoen – Voss, Hordaland
ENBN (BNN) – Brønnøysund Airport, Brønnøy – Brønnøysund, Nordland
ENBO (BOO) – Bodø Airport – Bodø, Nordland
ENBR (BGO) – Bergen Airport, Flesland – Bergen, Hordaland
ENBS (BJF) – Båtsfjord Airport – Båtsfjord, Finnmark
ENBV (BVG) – Berlevåg Airport – Berlevåg, Finnmark
ENCN (KRS) – Kristiansand Airport, Kjevik – Kristiansand, Vest-Agder
ENDI (DLD) – Geilo Airport, Dagali – Geilo, Buskerud
ENDR – Draugen – Draugen oil field, Norwegian Sea
ENDU (BDU) – Bardufoss Airport – Bardufoss, Troms
ENEG – Hønefoss Airport, Eggemoen – Hønefoss, Buskerud
ENEV (EVE) – Harstad/Narvik Airport, Evenes – Evenes, Nordland / Troms
ENFB (FBU) – Oslo Airport, Fornebu (closed) – Oslo, Akershus
ENFG (VDB) – Fagernes Airport, Leirin – Fagernes, Oppland
ENFL (FRO) – Florø Airport – Florø, Sogn og Fjordane
ENFR – Frigg – North Sea
ENGA – Gullfaks A – Gullfaks oil field, North Sea
ENGC – Gullfaks C – Gullfaks oil field, North Sea
ENGM (OSL) – Oslo Airport, Gardermoen – Gardermoen (near Oslo), Akershus
ENHA (HMR) – Hamar Airport, Stafsberg – Hamar, Hedmark
ENHD (HAU) – Haugesund Airport, Karmøy – Haugesund, Rogaland
ENHE – Heidrun – Heidrun oil field, North Sea
ENHF (HFT) – Hammerfest Airport – Hammerfest, Finnmark
ENHK (HAA) – Hasvik Airport – Hasvik, Finnmark
ENHN – Elverum Airport, Starmoen – Elverum, Hedmark
ENHS – Hokksund Airport – Hokksund, Buskerud
ENHV (HVG) – Honningsvåg Airport, Valan – Honningsvåg, Finnmark
ENJA – Jan Mayensfield – Jan Mayen
ENJB – Tønsberg Airport, Jarlsberg – Tønsberg, Vestfold
ENKB (KSU) – Kristiansund Airport, Kvernberget – Kristiansund, Møre og Romsdal
ENKJ – Kjeller Airport – Kjeller, Akershus
ENKR (KKN) – Kirkenes Airport, Høybuktmoen – Kirkenes, Finnmark
ENLI (FAN) – Farsund Airport, Lista – Farsund, Vest-Agder
ENLK (LKN) – Leknes Airport – Leknes, Nordland
ENMH (MEH) – Mehamn Airport – Mehamn, Finnmark
ENML (MOL) – Molde Airport, Årø – Molde, Møre og Romsdal
ENMS (MJF) – Mosjøen Airport, Kjærstad – Mosjøen, Nordland
ENNA (LKL) – Lakselv Airport, Banak – Lakselv, Finnmark
ENNK (NVK) – Narvik Airport, Framnes – Narvik, Nordland
ENNM (OSY) – Namsos Airport – Namsos, Nord-Trøndelag
ENNO – Notodden Airport – Notodden, Telemark
ENOA – Oseberg A – Oseberg oil field, North Sea
ENOL (OLA) – Ørland Main Air Station –, Sør-Trøndelag
ENOP – Oppdal Airport, Fagerhaug – Oppdal, Sør-Trøndelag
ENOV (HOV) – Ørsta-Volda Airport, Hovden – Ørsta/Volda, Møre og Romsdal
ENRA (MQN) – Mo i Rana Airport, Røssvoll – Mo i Rana, Nordland
ENRI – Ringebu Airport, Frya – Ringebu, Oppland
ENRK – Rakkestad Airport, Åstorp – Rakkestad, Østfold
ENRM (RVK) – Rørvik Airport, Ryum – Rørvik, Nord-Trøndelag
ENRO (RRS) – Røros Airport – Røros, Sør-Trøndelag
ENRS (RET) – Røst Airport – Røst, Nordland
ENRV – Reinsvoll Airport – Reinsvoll, Oppland
ENRY (RYG) - Rygge Airport/Rygge Air Station - Rygge
ENSA – Svea Airport – Sveagruva, Svalbard
ENSB (LYR) – Svalbard Airport, Longyear – Longyearbyen, Svalbard
ENSD (SDN) – Sandane Airport, Anda – Sandane, Sogn og Fjordane
ENSG (SOG) – Sogndal Airport, Haukåsen – Sogndal, Sogn og Fjordane
ENSH (SVJ) – Svolvær Airport, Helle – Svolvær, Nordland
ENSK (SKN) – Stokmarknes Airport, Skagen – Stokmarknes, Nordland
ENSN (SKE) – Skien Airport, Geiteryggen – Skien, Telemark
ENSO (SRP) – Stord Airport, Sørstokken – Leirvik, Hordaland
ENSR (SOJ) – Sørkjosen Airport – Nordreisa, Troms
ENSS (VAW) – Vardø Airport, Svartnes – Vardø, Finnmark
ENST (SSJ) – Sandnessjøen Airport, Stokka – Sandnessjøen, Nordland
ENSU – Sunndalsøra Airport, Vinnu – Sunndalsøra, Møre og Romsdal
ENTC (TOS) – Tromsø Airport, Langnes – Tromsø, Troms
ENTO (TRF) – Sandefjord Airport, Torp – Sandefjord, Vestfold
ENUK (GLL) – Gol Airport, Klanten – Gol, Buskerud
ENVA (TRD) – Trondheim Airport, Værnes – Stjørdal, Nord-Trøndelag
ENVD (VDS) – Vadsø Airport – Vadsø, Finnmark
ENVR (VDS) – Værøy Heliport – Værøy, Nordland
ENZV (SVG) – Stavanger Airport, Sola – Stavanger, Rogaland


== EP - Poland ==
Also see airport category and list.

EPBY (BZG) – Bydgoszcz Ignacy Jan Paderewski Airport – Bydgoszcz
EPGD (GDN) – Gdańsk Lech Wałęsa Airport – Gdańsk
EPKK (KRK) – John Paul II International Airport Kraków-Balice – Kraków
EPKT (KTW) – International Airport Katowice in Pyrzowice – Katowice
EPLL (LCJ) – Łódź Władysław Reymont Airport (formerly Łódź-Lublinek Airport) – Łódź
EPMO – Modlin Airport – Nowy Dwór Mazowiecki
EPPO (POZ) – Poznań-Ławica Airport – Poznań
EPRZ (RZE) – Rzeszów-Jasionka Airport – Rzeszów
EPSC (SZZ) – Szczecin-Goleniów "Solidarność" Airport – Szczecin
EPSY (SZY) – Szczytno-Szymany International Airport – Szczytno
EPWA (WAW) – Warsaw Frederic Chopin Airport (formerly Okecie International Airport) – Warsaw
EPWR (WRO) – Copernicus Airport Wrocław – Wrocław
EPZG (IEG) – Zielona Góra-Babimost Airport – Zielona Góra


== ES - Sweden ==
Also see airport category and list.

ESCF – Malmen Air Base – Linköping
ESCK – Bråvalla Air Base (closed) – Norrköping
ESCM – Uppsala Airport / Ärna Air Base (F 16) – Uppsala
ESCN – Tullinge Airport (closed) – Stockholm
ESDF (RNB) – Ronneby Airport (F 17) – Ronneby
ESFA – Bokeberg Airport – Hässleholm
ESFH – Hasslösa Air Base (closed) – Hasslösa
ESFI – Knislinge Air Base (closed) – Knislinge
ESFJ – Sjöbo Air Base – Sjöbo
ESFM – Moholm Air Base (closed) – Moholm
ESFQ – Kosta Air Base (closed) – Kosta
ESFR – Råda Air Base – Råda
ESFS – Sandvik Airport – Sandvik
ESFU – Uråsa Air Base (closed) – Växjö
ESFY – Byholma Air Base – Byholma
ESGA – Backamo Airport – Uddevalla
ESGC – Ålleberg Airport – Ålleberg
ESGD – Bämmelshed Airport – Tidaholm
ESGE – Viared Airport – Borås
ESGF – Morup Airport – Falkenberg
ESGG (GOT) – Göteborg-Landvetter Airport – Göteborg
ESGH – Herrljunga Airport – Herrljunga
ESGI – Alingsås Airport – Alingsås
ESGJ (JKG) – Jönköping Airport – Jönköping
ESGK – Falköping Airport – Falköping
ESGL (LDK) – Lidköping-Hovby Airport – Lidköping
ESGM – Öresten Airport – Öresten
ESGN – Brännebrona Airport – Götene
ESGP (GSE) – Göteborg City Airport (Säve) – Göteborg
ESGR (KVB) – Skövde Airport – Skövde
ESGS – Näsinge Airport – Strömstad
ESGT (THN) – Trollhättan-Vänersborg Airport – Trollhättan / Vänersborg
ESGU – Rörkärr Airport – Uddevalla
ESGV – Varberg Airport – Varberg
ESGY – Säffle Airport – Säffle
ESIA – Karlsborg Air Base – Karlsborg
ESIB – Såtenäs Air Base – Såtenäs
ESKA – Gimo Air Base – Gimo
ESKB – Barkarby Airport – Stockholm
ESKC – Sundbro Airport – Sundbro
ESKD – Dala-Järna Airport – Dala-Järna
ESKG – Gryttjom Airport – Gryttjom
ESKH – Ekshärad Airport – Ekshärad
ESKK (KSK) – Karlskoga Airport – Karlskoga
ESKM (MXX) – Mora-Siljan Airport – Mora
ESKN (NYO) – Stockholm-Skavsta Airport – Stockholm / Nyköping
ESKO – Munkfors Airport – Munkfors
ESKS – Strangnas Air Base (closed) – Strangnas
ESKT – Tierp Airport – Tierp
ESKU – Sunne Airport – Sunne
ESKV – Arvika-Westlanda Airport – Arvika
ESKX – Björkvik Air Base (closed) – Björkvik
ESMA – Emmaboda Airport – Emmaboda
ESMB – Borglanda Airport – Borglanda
ESMC – Ränneslätt Airport – Eksjö
ESMD – Vankiva Airport – Hässleholm
ESME – Eslöv Airport – Eslöv
ESMF – Fagerhult Airport – Fagerhult
ESMG – Feringe Airport – Ljungby
ESMH – Höganäs Airport – Höganäs
ESMI – Sövdeborg Airport – Sövdeborg
ESMJ – Kågeröd Airport – Kågeröd
ESMK (KID) – Kristianstad Airport – Kristianstad
ESML – Landskrona Airport – Landskrona
ESMN – Lund Airport – Lund
ESMO (OSK) – Oskarshamn Airport – Oskarshamn
ESMP – Anderstorp Airport – Anderstorp
ESMQ (KLR) – Kalmar Airport – Kalmar
ESMR – Trelleborg Airport (Maglarp Airport) – Trelleborg
ESMS (MMX) – Malmö-Sturup Airport – Malmö
ESMT (HAD) – Halmstad Airport – Halmstad
ESMU – Möckeln Airport – Älmhult
ESMV – Hagshult Air Base – Hagshult
ESMW – Tingsryd Airport (closed) – Tingsryd
ESMX (VXO) – Växjö Airport (Kronoberg Airport) – Växjö
ESMY – Smålandsstenar Airport – Smålandsstenar
ESMZ – Ölanda Airport – Ölanda
ESNA – Hallviken Airport – Hallviken
ESNB – Sollefteå Airport – Sollefteå
ESNC – Hedlanda Airport – Hede
ESND (EVG) – Sveg Airport – Sveg
ESNE – Överkalix Airport – Överkalix
ESNF – Farila Air Base – Farila
ESNG (GEV) – Gällivare Airport – Gällivare
ESNH (HUV) – Hudiksvall Airport – Hudiksvall
ESNI – Kubbe Air Base (closed) – Kubbe
ESNJ – Jokkmokk Air Base – Jokkmokk
ESNK (KRF) – Kramfors-Sollefteå Airport – Kramfors / Sollefteå
ESNL (LYC) – Lycksele Airport – Lycksele
ESNM – Optand Airport – Optand
ESNN (SDL) – Sundsvall-Härnösand Airport – Sundsvall / Härnösand
ESNO (OER) – Örnsköldsvik Airport – Örnsköldsvik
ESNP – Piteå Airport – Piteå
ESNQ (KRN) – Kiruna Airport – Kiruna
ESNR – Orsa Airport – Orsa
ESNS (SFT) – Skellefteå Airport – Skellefteå
ESNT – Sattna Air Base (closed) – Sattna
ESNU (UME) – Umeå Airport – Umeå
ESNV (VHM) – Vilhelmina Airport – Vilhelmina
ESNX (AJR) – Arvidsjaur Airport – Arvidsjaur
ESNY (SOO) – Söderhamn Airport – Söderhamn
ESNZ (OSD) – Östersund Airport (F4 Frösön Air Base) – Östersund
ESOE (ORB) – Örebro Airport – Örebro
ESOH (HFS) – Hagfors Airport – Hagfors
ESOK (KSD) – Karlstad Airport – Karlstad
ESOL – Lemstanäs Airport – Storvik
ESOW (VST) – Stockholm-Västerås Airport (Hässlö, former F1) – Stockholm / Västerås
ESPA (LLA) – Luleå Airport (Kallax Air Base) – Luleå
ESPE – Vidsel Air Base – Vidsel
ESPG – Boden Army Air Base (closed) – Boden
ESPJ – Heden Air Base (closed) – Heden
ESQO – Arboga Airport – Arboga
ESQP – Berga Airport (closed) – Berga
ESSA (ARN) – Stockholm-Arlanda Airport – Stockholm
ESSB (BMA) – Stockholm-Bromma Airport – Stockholm
ESSC – Ekeby Airport – Eskilstuna
ESSD (BLE) – Borlänge Airport – Borlänge
ESSE – Skå-Edeby Airport – Stockholm
ESSF (HLF) – Hultsfred-Vimmerby Airport – Hultsfred / Vimmerby
ESSG – Ludvika Airport – Ludvika
ESSH – Laxå Airport – Laxå
ESSI – Visingsö Airport – Visingsö
ESSK (GVX) – Gävle-Sandviken Airport – Gävle / Sandviken
ESSL (LPI) – Linköping-Saab Airport – Linköping
ESSM – Brattforsheden Airport – Brattforsheden
ESSN – Norrtälje Airport – Norrtälje
ESSP (NRK) – Kungsängen Airport – Norrköping
ESST (TYF) – Torsby Airport (Fryklanda Airport) – Torsby
ESSU (EKT) – Eskilstuna Airport – Eskilstuna
ESSV (VBY) – Visby Airport – Visby
ESSW (VVK) – Västervik Airport – Västervik
ESSX – Johannisberg Airport – Västerås
ESSZ – Vängsö Airport – Vängsö
ESTA (AGH) – Ängelholm-Helsingborg Airport – Ängelholm / Helsingborg
ESTF – Fjallbacka Airport – Fjällbacka
ESTG – Grönhögen Airport – Grönhögen
ESTL – Ljungbyhed Airport – Ljungbyhed
ESTO – Tomelilla Airport – Tomelilla
ESTT – Vellinge Airport – Vellinge
ESUA – Åmsele Air Base (closed) – Åmsele
ESUB – Arbrå Airport – Arbrå
ESUD (SQO) – Storuman Airport – Storuman
ESUE (IDB) – Idre Airport – Idre
ESUF – Fallfors Air Base (closed) – Fallfors
ESUG – Gargnäs Airport – Gargnäs
ESUH – Myran Airport – Härnösand
ESUI – Mellansel Airport – Mellansel
ESUJ – Tälje Airport – Ånge
ESUK – Kalixfors Army Air Base – Kalixfors
ESUL – Ljusdal Airport – Ljusdal
ESUM – Mohed Airport – Mohed
ESUO – Oviken Airport – Oviken
ESUP (PJA) – Pajala Airport – Pajala
ESUR – Ramsele Airport – Ramsele
ESUS – Åsele Airport – Åsele
ESUT (HMV) – Hemavan Airport – Hemavan
ESUV – Älvsbyn Airport – Älvsbyn
ESUY – Edsbyn Airport – Edsbyn
ESVA – Avesta Airport – Avesta
ESVB – Bunge Airport – Bunge
ESVG – Gagnef Airport – Gagnef
ESVH – Hällefors Airport – Hällefors
ESVK – Katrineholm Airport – Katrineholm
ESVM – Skinnlanda Airport – Malung
ESVQ – Köping Airport – Köping
ESVS – Siljansnäs Airport – Siljansnäs


== EV - Latvia ==
Also see airport category and list.

EVDA (DGP) – Daugavpils Airport – Daugavpils
EVEA - Jelgava - Jelgava
EVLA (LPX) – Liepāja International Airport – Liepāja
EVRA (RIX) – Rīga International Airport – Rīga
EVVA (VTS) – Ventspils International Airport – Ventspils


== EY - Lithuania ==
Also see airport category and list.

EYAL – Alytus Airport – Alytus
EYBI – Biržai Airport – Biržai
EYJB – Jurbarkas Airport – Jurbarkas
EYKA (KUN) – Kaunas International Airport – Kaunas
EYKD – Kėdainiai Airport – Kėdainiai
EYKG – Kaunas/Gamykla Airport – Kaunas
EYKL (KLJ) – Klaipėda Airport – Klaipėda
EYKR – Kazlų Rūda Airport (Military) – Kazlų Rūda
EYKS – S. Darius and S. Girėnas Airport – Kaunas
EYKT – Kartena Airport – Kartena
EYMA – Tirkšliai Airport – Tirkšliai
EYMM – Sasnava Airport – Sasnava
EYNA – Akmenė Airport – Akmenė
EYND – Nida Airport – Nida
EYNE – Nemirseta Airport – Nemirseta
EYPA (PLQ) – Palanga International Airport – Palanga
EYPI – Panevėžys/Istra Airport – Panevėžys
EYPK – Pikeliškės Airport – Pikeliškės
EYPN – Panevėžys Airport – Panevėžys
EYPP (PNV) – Pajuostis Airport (Military) – Pajuostis
EYPR – Pociūnai Airport – Pociūnai
EYRK – Rokiškis Airport – Rokiškis
EYRU – Rukla Airport – Jonava
EYSA (SQQ) – Šiauliai International Airport (Civil/Military) – Šiauliai
EYSB (HLJ) – Barysiai Airport (Civil/Military) – Barysiai
EYSE – Šeduva Airport – Šeduva
EYSI – Šilutė Airport (Military) – Šilutė
EYTL – Telšiai Airport – Telšiai
EYUT – Utena Airport – Utena
EYVA – Vilnius (MOT/CAD)
EYVC – Vilnius (ACC/FIC/COM/RCC)
EYVI (VNO) – Vilnius International Airport – Vilnius
EYVK – Kyviškės Airport (Military) – Kyviškės
EYVL – Vilnius (FIR)
EYVN – Vilnius (NOF/AIS)
EYVP – Paluknys Airport – Paluknys
EYZA – Zarasai Airport – Zarasai
EYZE – Žekiškės Airport – Žekiškės


== References ==
"ICAO Location Indicators by State" (PDF). International Civil Aviation Organization. 2006-01-12. मूल से 26 सितंबर 2007 को पुरालेखित (PDF). अभिगमन तिथि 14 अप्रैल 2009."संयुक्त राष्ट्र Code for Trade and Transport Locations] [includes IATA codes". UN/LOCODE 2006-2. UNECE. 2007-04-30. मूल से 9 मई 2007 को पुरालेखित. अभिगमन तिथि 14 अप्रैल 2009.