revision: 4796601
title: Lichinga
url: https://hi.wikipedia.org/wiki/%E0%A4%B5%E0%A4%BF%E0%A4%AE%E0%A4%BE%E0%A4%A8%E0%A4%95%E0%A5%8D%E0%A4%B7%E0%A5%87%E0%A4%A4%E0%A5%8D%E0%A4%B0%E0%A5%8B%E0%A4%82_%E0%A4%95%E0%A5%80_%E0%A4%B8%E0%A5%82%E0%A4%9A%E0%A5%80_ICAO_%E0%A4%95%E0%A5%8B%E0%A4%A1_%E0%A4%85%E0%A4%A8%E0%A5%81%E0%A4%B8%E0%A4%BE%E0%A4%B0:_F


---

The countries whose ICAO code starts with 'F' are primarily in southern Africa.
Format of entries is:

ICAO (IATA) – Airport Name – Airport Location


== FA – South Africa ==
Also see airport category and list.

FABE (BIY) – Bisho Airport – Bisho
FABL (BFN) – Bloemfontein Airport – Bloemfontein
FABM (BHM) – Bethlehem Airfield – Bethlehem
FABU (UTE) – Butterworth Airport – Butterworth
FACD (CDO) – Cradock Airport – Cradock
FACT (CPT) – Cape Town International Airport – Cape Town
FADN (DUR) – Durban International Airport – Durban
FAEL (ELS) – East London Airport – East London
FAEM (EMG) – Empangeni Airport – Empangeni
FAER (ELL) – Ellisras (Mitimba) Airport – Ellisras
FAFB (FCB) – Ficksburg Airport – Ficksburg
FAFK () – Fisantekraal Airfield – Fisantekraal,Durbanville
FAGC (GCJ) – Grand Central Airport – Johannesburg
FAGG (GRJ) – George Airport – George
FAGI (GIY) – Giyani Airport – Giyani
FAGM (QRA) – Rand Airport – Johannesburg
FAHL (HLW) – Hluhluwe Airport – Hluhluwe
FAHR (HRS) – Harrismith Airport – Harrismith
FAJS (JNB) – OR Tambo International Airport – Johannesburg
FAKD (KXE) – Klerksdorp Airport – Klerksdorp
FAKF – Kersefontein Farm – Hopefield
FAKM (KIM) – Kimberley Airport – Kimberley
FAKN (MQP) – Kruger Mpumalanga International Airport – Nelspruit (Kruger National Park)
FAKO () – Komga – Komga
FAKP (KOF) – Komatipoort Airport – Komatipoort
FAKR () – Krugersdorp Airport – Krugersdorp
FAKU (KMH) – Johan Pienaar Airport – Kuruman
FAKZ (KLZ) – Kleinsee Airport – Kleinsee
FALA (HLA) – Lanseria Airport – Lanseria
FALC (LMR) – Finsch Mine Airport – Lime Acres
FALK (LUJ) – Lusikisiki Airport – Lusikisiki
FALM (LCD) – AFB Makhado, SAAF – Makhado
FALW (LGE) – AFB Langebaanweg SAAF – Langebaan
FALY (LAY) – Ladysmith Airport – Ladysmith
FAMD (AAM) – Malamala Airport – Malamala
FAMG (MGH) – Margate Airport – Margate
FAMM (MBD) – Mmabatho International Airport – Mmabatho
FAMN (LLE) – Malelane Airport – Malelane
FAMO (MZY) – Mossel Bay Airport – Mossel Bay
FAMS (MEZ) – Messina Airport – Messina
FAMU (MZQ) – Mkuze Airport – Mkuze
FAMW (MZF) – Mzamba (Wild Coast) Airport – Mzamba
FANC (NCS) – Newcastle Airport – Newcastle
FANG (NGL) – Ngala Airfield Airport – Ngala
FANS (NLP) – Nelspruit Airport – Nelspruit
FAOI – Orient Airfield ndash; Magaliesburg
FAOH (OUH) – Oudtshoorn Airport – Oudtshoorn
FAPA (AFD) – Port Alfred Airport – Port Alfred
FAPE (PLZ) – Port Elizabeth Airport – Port Elizabeth
FAPG (PBZ) – Plettenberg Bay Airport – Plettenberg Bay
FAPH (PHW) – Hendrik Van Eck Airport – Phalaborwa
FAPJ (JOH) – Port St. Johns Airport – Port St. Johns
FAPK (PRK) – Prieska Airport – Prieska
FAPM (PZB) – Pietermaritzburg Airport – Pietermaritzburg
FAPN (NTY) – Pilanesberg International Airport – Pilanesberg (near Sun City)
FAPP (PTG) – Polokwane International Airport – Polokwane
FAQT (UTW) – Queenstown Airport – Queenstown
FARB (RCB) – Richards Bay Airport – Richards Bay
FARS (ROD) – Robertson Airport – Robertson
FASB (SBU) – Springbok Airport – Springbok
FASC (ZEC) – Secunda Airport – Secunda
FASD (SDB) – Vredenburg Airport – Saldanha Bay
FASE – Sabi Sabi
FASH – Stellenbosch Flying Club – Stellenbosch
FASS (SIS) – Sishen Airport – Sishen
FASZ (SZK) – Skukuza Airport – Skukuza
FATA – Teddarfield Airpark
FATH (THY) – P.R. Mphephu Airport – Thohoyandou
FATN (TCU) – Thaba Nchu Airport – Thaba Nchu
FATP – New Tempe – Bloemfontein
FATZ (LTA) – Tzaneen Airport – Tzaneen
FAUL (ULD) – Ulundi Airport – Ulundi
FAUP (UTN) – Upington Airport – Upington
FAUT (UTT) – K. D. Matanzima Airport – Umtata
FAVB (VRU) – Vryburg Airport – Vryburg
FAVG (VIR) – Virginia Airport – Durban
FAVR (VRF) – Vredendal Airport – Vredendal
FAVY (VYD) – Vryheid Airport – Vryheid
FAWB (PRY) – Wonderboom Airport – Pretoria
FAWK (IZA) – AFBWaterkloof, SAAF – Tshwane
FAWM (WEL) – Welkom Airport – Welkom
FAYP – Ysterplaat AFB – Cape Town


== FB – Botswana ==
Also see airport category and list.

FBFT (FRW) – Francistown Airport – Francistown
FBGM – Gumare Airport – Gumare
FBGZ (GNZ) – Ghanzi Airport – Ghanzi
FBJW (JWA) – Jwaneng Airport – Jwaneng
FBKE (BBK) – Kasane Airport – Kasane
FBKG – Kang Airport – Kang
FBKR (KHW) – Khwai River Airport – Khwai River
FBKY – Kanye Airport – Kanye
FBLO (LOQ) – Lobatse Airport – Lobatse
FBMM – Makalamabedi Airport – Makalamabedi
FBMN (MUB) – Maun Airport – Maun
FBNN – Nokaneng Airport – Nokaneng
FBNT – Nata Airport – Nata
FBOR (ORP) – Orapa Airport – Orapa
FBPY (QPH) – Palapye Airport – Palapye
FBRK – Rakops Airport – Rakops
FBSK (GBE) – Sir Seretse Khama International Airport – Gaborone
FBSN (SXN) – Sua Pan Airport – Sua Pan
FBSP (PKW) – Selebi-Phikwe Airport – Selebi-Phikwe
FBSR – Serowe Airport – Serowe
FBSV (SVT) – Savuti Airport – Savuti
FBSW (SWX) – Shakawe Airport – Shakawe
FBTE – Tshane Airport – Tshane
FBTL (TLD) – Tuli Lodge Airport – Tuli Lodge
FBTS (TBY) – Tshabong Airport – Tshabong
FBXG – Xugana Airport – Xugana


== FC – Republic of the Congo (ROC), formerly known as Congo ==
Also see airport category and list.

FCBB (BZV) – Maya-Maya Airport – Brazzaville
FCBD (DJM) – Djambala Airport – Djambala
FCBK (KNJ) – Kindamba Airport – Kindamba
FCBL (LCO) – Lague Airport – Lague
FCBM (MUY) – Mouyondzi Airport – Mouyondzi
FCBS (SIB) – Sibiti Airport – Sibiti
FCBY (NKY) – Yokangassi Airport – Nkayi
FCBZ (ANJ) – Zanaga Airport – Zanaga
FCMM (MSX) – Mossendjo Airport – Mossendjo
FCOB (BOE) – Boundji Airport – Boundji
FCOE (EWO) – Ewo Airport – Ewo
FCOG (GMM) – Gamboma Airport – Gamboma
FCOI (ION) – Impfondo Airport – Impfondo
FCOK (KEE) – Kelle Airport – Kelle
FCOM (MKJ) – Makoua Airport – Makoua
FCOO (FTX) – Owando Airport – Owando
FCOS (SOE) – Souanke Airport – Souanke
FCOT (BTB) – Betou Airport – Betou
FCOU (OUE) – Ouesso Airport – Ouesso
FCPA (KMK) – Makabana Airport – Makabana
FCPL (DIS) – Loubomo Airport – Loubomo
FCPP (PNR) – Pointe Noire Airport – Pointe-Noire


== FD – Swaziland ==
Also see airport category and list.

FDMB (QMN) – Mbabane Airport – Mbabane
FDMS (MTS) – Matsapha Airport – Manzini


== FE – Central African Republic ==
Also see airport category and list.

FEFA   - Alindao Airport - Alindao
FEFB (OBX) – Poste Airport – Obo
FEFC (CRF) – Carnot Airport – Carnot
FEFE   - Mobaye Mbanga Airport - Mobaye
FEFF (BGF) – Bangui M'Poko International Airport – Bangui
FEFG (BGU) – Bangassou Airport – Bangassou
FEFI (IRO) – Birao Airport – Birao
FEFL (BEM) – Bossembele Airport – Bossembélé
FEFM (BBY) – Bambari Airport – Bambari
FEFN (NDL) – N'Délé Airport – N'Délé
FEFO (BOP) – Bouar Airport – Bouar
FEFP   - Paoua Airport - Paoua
FEFR (BIV) – Bria Airport – Bria
FEFS (BSN) – Bossangoa Airport – Bossangoa
FEFT (BBT) – Berberati Airport – Berbérati
FEFU   - Sibut Airport - Sibut
FEFW (ODA) – Ouadda Airport – Ouadda
FEFY (AIG) – Yalinga Airport – Yalinga
FEFZ (IMO) – Zemio Airport – Zemio
FEGC   - Bocaranga Airport - Bocaranga
FEGE (MKI) - M'Boki Airport - Obo
FEGF (BTG) – Batangafo Airport – Batangafo
FEGL (GDI) - Gordil Airport - Gordil
FEGM (BMF) – Bakouma Airport – Bakouma
FEGO (ODJ) – Ouanda Djallé Airport – Ouanda Djallé
FEGR (RFA) – Rafai Airport – Rafaï
FEGU (BCF) – Bouca Airport – Bouca
FEGZ (BOZ) – Bozoum Airport – Bozoum


== FG – Equatorial Guinea ==
Also see airport category and list.

FGBT (BSG) – Bata Airport – Bata
FGSL (SSG) – Malabo Airport – Malabo


== FH – Ascension Island ==
Also see airport category and list.

FHAW (ASI) – Wideawake Field (Ascension Aux. AF) – Georgetown


== FI – Mauritius ==
Also see airport category and list.

FIMP (MRU) – Sir Seewoosagur Ramgoolam International Airport – Plaine Magnien (near Port Louis)
FIMR (RRG) – Rodrigues Island Airport (Plaine Corail Airport) – Rodrigues Island


== FJ – British Indian Ocean Territory ==
Also see airport category and list.

FJDG (NKW) – Diego Garcia Tracking Station – Diego Garcia


== FK – Cameroon ==
Also see airport category and list.

FKKB (KBI) – Kribi Airport – Kribi
FKKC (TKC) – Tiko Airport – Tiko
FKKD (DLA) – Douala International Airport – Douala
FKKF (MMF) – Mamfe Airport – Mamfe
FKKG (BLC) – Bali Airport – Bali
FKKH (KLE) – Kaélé Airport – Kaélé
FKKI (OUR) – Batouri Airport – Batouri
FKKJ (GXX) – Yagoua Airport – Yagoua
FKKL (MVR) – Salak Airport – Maroua
FKKM (FOM) – Nkounja Airport – Foumban
FKKN (NGE) – N'Gaoundéré Airport – N'Gaoundéré
FKKO (BTA) – Bertoua Airport – Bertoua
FKKR (GOU) – Garoua International Airport – Garoua
FKKS (DSC) – Dschang Airport – Dschang
FKKU (BFX) – Bafoussam Airport – Bafoussam
FKKV (BPC) – Bamenda Airport – Bamenda
FKKW (EBW) – Ebolowa Airport – Ebolowa
FKKY (YAO) – Yaoundé Airport – Yaoundé
FKYS (NSI) – Yaoundé Nsimalen International Airport – Yaoundé


== FL – Zambia ==
Also see airport category and list.

FLBA (MMQ) – Mbala Airport – Mbala
FLCP (CIP) – Chipata Airport – Chipata
FLKE (ZKP) – Kasompe Airport – Kasompe
FLKL (KLB) – Kalabo Airport – Kalabo
FLKO (KMZ) – Kaoma Airport – Kaoma
FLKS (KAA) – Kasama Airport – Kasama
FLKW (QKE) – Milliken Airport – Kabwe
FLLI (LVI) – Livingstone Airport – Livingstone
FLLK (LXU) – Lukulu Airport – Lukulu
FLLS (LUN) – Lusaka International Airport – Lusaka
FLMA (MNS) – Mansa Airport – Mansa
FLMF (MFU) – Mfuwe Airport – Mfuwe
FLMG (MNR) – Mongu Airport – Mongu
FLND (NLA) – Ndola Airport – Ndola
FLSN (SXG) – Senanga Airport – Senanga
FLSO (KIW) – Southdowns Airport – Kitwe
FLSS (SJQ) – Sesheke Airport – Sesheke
FLSW (SLI) – Solwezi Airport – Solwezi
FLZB (BBZ) – Zambezi Airport – Zambezi


== FM – Comoros, Mayotte, Réunion, and Madagascar ==


=== Comoros ===
Also see airport category and list.

FMCH (HAH) – Prince Said Ibrahim International Airport – Moroni, Comoros
FMCI (NWA) – Mohéli Bandar Es Eslam Airport – Mohéli, Comoros
FMCN (YVA) – Iconi Airport – Moroni, Comoros
FMCV (AJN) – Ouani Airport – Anjouan, Comoros


=== Mayotte ===
Also see airport category and list.

FMCZ (DZA) – Dzaoudzi Pamandzi International Airport – Dzaoudzi, Mayotte


=== Réunion ===
Also see airport category and list.

FMEE (RUN) – Roland Garros Airport – Saint-Denis, Réunion
FMEP (ZSE) – Pierrefonds Airport – Saint-Pierre, Réunion


=== Madagascar ===
Also see airport category and list.

FMMC (WML) – Malaimbandy Airport – Malaimbandy, Madagascar
FMME (ATJ) – Antsirabe Airport – Antsirabé, Madagascar
FMMG (WAQ) – Antsalova Airport – Antsalova, Madagascar
FMMI (TNR) – Ivato International Airport – Antanànarìvo, Madagascar
FMMK (JVA) – Ankavandra Airport – Ankavandra, Madagascar
FMML (BMD) – Belo Sur Tsiribihina Airport – Belo, Madagascar
FMMN (ZVA) – Miandrivazo Airport – Miandrivazo, Madagascar
FMMO (MXT) – Maintirano Airport – Maintirano, Madagascar
FMMQ (ILK) – Ilaka-Est Airport – Ilaka-Est, Madagascar
FMMR (TVA) – Morafenobe Airport – Morafenobe, Madagascar
FMMS (SMS) – Saints Marie Airport – Île Sainte-Marie, Madagascar
FMMT (TMM) – Toamasina Airport – Toamasina, Madagascar
FMMU (WTA) – Tambohorano Airport – Tambohorano, Madagascar
FMMV (MOQ) – Morondava Airport – Morondava, Madagascar
FMMX (WTS) – Tsiroanomandidy Airport – Tsiroanomandidy, Madagascar
FMMY (VAT) – Vatomandry Airport – Vatomandry, Madagascar
FMMZ (WAM) – Ambatondrazaka Airport – Ambatondrazaka, Madagascar
FMNA (DIE) – Arrachart Airport – Antsiranana, Madagascar
FMNC (WMR) – Mananara Nord Airport – Mananara Nord, Madagascar
FMND (ZWA) – Andapa Airport – Andapa, Madagascar
FMNF (WBD) – Befandriana Nord Airport – Befandriana Nord, Madagascar
FMNG (WPB) – Port Berge Airport – Port Berge, Madagascar
FMNH (ANM) – Antsirabato Airport – Antalaha, Madagascar
FMNJ (IVA) – Ambanja Airport – Ambanja, Madagascar
FMNL (HVA) – Analalava Airport – Analalava, Madagascar
FMNM (MJN) – Amborovy Airport – Mahajanga, Madagascar
FMNN (NOS) – Fascene Airport – Nosy Be, Madagascar
FMNO (DWB) – Soalala Airport – Soalala, Madagascar
FMNQ (BPY) – Besalampy Airport – Besalampy, Madagascar
FMNR (WMN) – Maroantsetra Airport – Maroantsetra, Madagascar
FMNS (SVB) – Sambava Sud Airport – Sambava Sud, Madagascar
FMNT (TTS) – Tsaratanana Airport – Tsaratanana, Madagascar
FMNV (VOH) – Vohemar Airport – Vohemar, Madagascar
FMNW (WAI) – Ambalabe Airport – Antsohihy, Madagascar
FMSB (WBO) – Antsoa Airport – Beroroha, Madagascar
FMSC (WMD) – Mandabe Airport – Mandabe, Madagascar
FMSD (FTU) – Tôlanaro Airport – Tôlanaro, Madagascar
FMSF (WFI) – Fianarantsoa Airport – Fianarantsoa, Madagascar
FMSI (IHO) – Ihosy Airport – Ihosy, Madagascar
FMSJ (MJA) – Manja Airport – Manja, Madagascar
FMSK (WVK) – Manakara Airport – Manakara, Madagascar
FMSL (OVA) – Bekily Airport – Bekily, Madagascar
FMSM (MNJ) – Mananjary Airport – Mananjary, Madagascar
FMSN (TDV) – Tanandava-Samangoky Airport – Tanandava-Samangoky, Madagascar
FMSR (MXM) – Morombe Airport – Morombe, Madagascar
FMST (TLE) – Toliara Airport – Toliara, Madagascar
FMSV (BKU) – Betioky Airport – Betioky, Madagascar
FMSY (AMP) – Ampanihy Airport – Ampanihy, Madagascar
FMSZ (WAK) – Ankazoabo Airport – Ankazoabo, Madagascar


== FN – Angola ==
Also see airport category and list.

FNAM (AZZ) – Ambriz Airport – Ambriz
FNBC (SSY) – Mbanza Congo Airport – Mbanza Congo
FNBG (BUG) – Benguela Airport – Benguela
FNCA (CAB) – Cabinda Airport – Cabinda
FNCF (CFF) – Cafunfo Airport – Cafunfo
FNCH (PGI) – Dundo Airport – Chitato
FNCT (CBT) – Catumbela Airport – Catumbela
FNCV (CTI) – Cuito Cuanavale Airport – Cuito Cuanavale
FNCZ (CAV) – Cazombo Airport – Cazombo
FNGI (NGV) – Ngiva Airport – Ngiva
FNHU (NOV) – Nova Lisboa Airport – Huambo
FNKU (SVP) – Kuito Airport – Kuito
FNLU (LAD) – Quatro de Fevereiro Airport – Luanda
FNMA (MEG) – Malanje Airport – Malanje
FNME (SPP) – Menongue Airport – Menongue
FNMO (MSZ) – Namibe Airport – Namibe
FNNG (GXG) – Negage Airport – Negage
FNPA (PBN) – Porto Amboim Airport – Porto Amboim
FNSA (VHC) – Saurimo Airport – Saurimo
FNSO (SZA) – Soyo Airport – Soyo
FNUB (SDD) – Lubango Airport – Lubango
FNUE (LUO) – Luena Airport – Luena
FNUG (UGO) – Uige Airport – Uíge
FNWK (CEO) – Waco Kungo Airport – Waco Kungo
FNXA (XGN) – Xangongo Airport – Xangongo
FNZE (ARZ) – N'zeto Airport – N'zeto


== FO – Gabon ==
Also see airport category and list.

FOGA (AKE) – Akieni Airport – Akieni
FOGB (BGB) – Booué Airport – Booué
FOGE (KDN) – Ndende Airport – Ndende
FOGF (FOU) – Fougamou Airport – Fougamou
FOGG (MBC) – Mbigou Airport – Mbigou
FOGI (MGX) – Moabi Airport – Moabi
FOGK (KOU) – Mabimbi Airport – Koulamoutou
FOGM (MJL) – Mouila (City) Airport – Mouila
FOGO (OYE) – Oyem Airport – Oyem
FOGQ (OKN) – Okondja Airport – Okondja
FOGR (LBQ) – Lambaréné Airport – Lambaréné
FOOB (BMM) – Bitam Airport – Bitam
FOOD (MFF) – Moanda Airport – Moanda
FOOE (MKB) – Mékambo Airport – Mékambo
FOOG (POG) – Port-Gentil Airport – Port-Gentil
FOOH (OMB) – Hospital Airport – Omboué
FOOI (IGE) – Tchongorove Airport – Iguela
FOOK (MKU) – Makokou Airport – Makokou
FOOL (LBV) – Leon M'Ba International Airport – Libreville
FOOM (MZC) – Mitzic Airport – Mitzic
FOON (MVB) – M'vengue Airport – Franceville
FOOR (LTL) – Lastourville Airport – Lastourville
FOOS (ZKM) – Sette Cama Airport – Sette Cama
FOOT (TCH) – Tchibanga Airport – Tchibanga
FOOY (MYB) – Mayumba Airport – Mayumba


== FP – São Tomé and Príncipe ==
Also see airport category and list.

FPPA (PGP) – Porto Alegre Airport – São Tomé
FPPR (PCP) – Príncipe Airport – Príncipe
FPST (TMS) – São Tomé International Airport (Salazar Airport) – São Tomé


== FQ – Mozambique ==
Also see airport category and list.

FQAG (ANO) – Angoche Airport – Angoche
FQBR (BEW) – Beira Airport – Beira
FQCB (FXO) – Cuamba Airport – Cuamba
FQCH (VPY) – Chimoio Airport – Chimoio
FQIN (INH) – Inhambane Airport – Inhambane
FQLC (VXC) – Lichinga Airport – Lichinga
FQLU (LFB) – Lumbo Airport – Lumbo
FQMA (MPM) – Maputo International Airport – Maputo
FQMD (MUD) – Mueda Airport – Mueda
FQMP (MZB) – Moçimboa da Praia Airport – Moçimboa da Praia
FQNC (MNC) – Nacala Airport – Nacala
FQNP (APL) – Nampula Airport – Nampula
FQPB (POL) – Pemba Airport – Pemba
FQQL (UEL) – Quelimane Airport – Quelimane
FQTT (TET) – Chingozi Airport – Tete
FQVL (VNX) – Vilankulo Airport – Vilankulo


== FS – Seychelles ==
Also see airport category and list.

FSDR (DES) – Desroches Airport – Desroches
FSIA (SEZ) – Seychelles International Airport – Mahe Island
FSPP (PRI) – Praslin Island Airport – Praslin Island
FSSB (BDI) – Bird Island Airport – Bird Island
FSSF (FRK) – Frégate Island Airport – Frégate Island


== FT – Chad ==
Also see airport category and list.

FTTA (SRH) – Sarh Airport – Sarh
FTTB (OGR) – Bongor Airport – Bongor
FTTC (AEH) – Abéché Airport – Abéché
FTTD (MQQ) – Moundou Airport – Moundou
FTTE – Biltine Airport – Biltine
FTTF – Fada Airport – Fada
FTTG – Goz Beïda Airport – Goz Beïda
FTTH (LTC) – Laï Airport – Laï
FTTI (ATV) – Ati Airport – Ati
FTTJ (NDJ) – N'Djamena International Airport – N'Djamena
FTTK (BKR) – Bokoro Airport – Bokoro
FTTL (OTC) – Bol Airport – Bol
FTTM (MVO) – Mongo Airport – Mongo
FTTN (AMC) – Am-Timan Airport – Am-Timan
FTTP (PLF) – Pala Airport – Pala
FTTR – Zouar Airport – Zouar
FTTS (OUT) – Bousso Airport – Bousso
FTTU (AMO) – Mao Airport – Mao
FTTY (FYT) – Faya-Largeau Airport – Faya-Largeau
FTTZ – Zougra Airport – Bardaï


== FV – Zimbabwe ==
Also see airport category and list.

FVBU (BUQ) – Joshua Mqabuko Nkomo International Airport – Bulawayo
FVCH (CHJ) – Chipinge Airport – Chipinge
FVCP – Charles Prince Airport – Harare
FVCZ (BFO) – Buffalo Range – Chiredzi
FVFA (VFA) – Victoria Falls Airport – Victoria Falls
FVGR (UTA) – Grand Reef Airport – Mutare
FVHA (HRE) – Harare International Airport – Harare
FVKB (KAB) – Kariba Airport – Kariba
FVMV (MVZ) – Masvingo Airport – Masvingo
FVTL (GWE) – Thornhill Airport – Gweru
FVWN (HWN) – Hwange National Park Airport – Hwange (Hwange National Park)
FVWT (WKI) – Hwange Town Airport – Hwange Town


== FW – Malawi ==
Also see airport category and list.

FWCL (BLZ) – Chileka International Airport – Blantyre
FWCM (CMK) – Club Makokola Airport – Club Makokola
FWDW (DWA) – Dwanga Airport – Dwanga
FWKA (KGJ) – Karonga Airport – Karonga
FWKI (LLW) – Lilongwe International Airport (Kamuzu Int'l) – Lilongwe
FWMG (MAI) – Mangochi Airport – Mangochi
FWMY (MYZ) – Monkey Bay Airport – Monkey Bay
FWSM (LMB) – Salima Airport – Salima
FWUU (ZZU) – Mzuzu Airport – Mzuzu


== FX – Lesotho ==
Also see airport category and list.

FXLK (LEF) – Lebakeng Airport – Lebakeng
FXLR (LRB) – Leribe Airport – Leribe
FXLS (LES) – Lesobeng Airport – Lesobeng
FXMA (MSG) – Matsaile Airport – Matsaile
FXMF (MFC) – Mafeteng Airport – Mafeteng
FXMK (MKH) – Mokhotlong Airport – Mokhotlong
FXMM (MSU) – Moshoeshoe International Airport – Maseru
FXMU - Mejametalana Airport - Maseru
FXNK (NKU) – Nkaus Airport – Nkaus
FXPG (PEL) – Pelaneng Airport – Pelaneng
FXQG (UTG) – Quthing Airport – Quthing
FXQN (UNE) – Qachas' Nek Airport – Qachas' Nek
FXSK (SKQ) – Sekake Airport – Sekake
FXSM (SOK) – Semongkong Airport – Semongkong
FXTA (THB) – Thaba Tseka Airport – Thaba Tseka
FXTK (TKO) – Tlokoeng Airport – Tlokoeng


== FY – Namibia ==
Also see airport category and list.

FYAR (ADI) – Arandis Airport – Arandis
FYGF (GFY) – Grootfontein Airport – Grootfontein
FYHI (HAL) – Halali Airport – Halali
FYKB (KAS) – Karasburg Airport – Karasburg
FYKT (KMP) – Keetmanshoop Airport – Keetmanshoop
FYLZ (LUD) – Lüderitz Airport – Lüderitz
FYMO (OKU) – Mokuti Lodge Airport – Mokuti Lodge
FYMP (MPA) – Mpacha Airport – Mpacha
FYNA (NNI) – Namutoni Airport – Namutoni
FYOA (OND) – Ondangwa Airport – Ondangwa
FYOE (OMG) – Omega Airport – Omega
FYOG (OMD) – Oranjemund Airport – Oranjemund
FYOO (OKF) – Okaukuejo Airport – Okaukuejo
FYOP (OPW) – Opuwa Airport – Opuwa
FYOS (OHI) – Oshakati Airport – Oshakati
FYRU (NDU) – Rundu Airport – Rundu
FYSM (SWP) – Swakopmund Airport – Swakopmund
FYTM (TSB) – Tsumeb Airport – Tsumeb
FYWB (WVB) – Walvis Bay Airport – Walvis Bay
FYWE (ERS) – Eros Airport – Windhoek
FYWH (WDH) – Windhoek Hosea Kutako International Airport – Windhoek


== FZ – Democratic Republic of the Congo (DRC), formerly known as Zaire ==
Also see airport category and list.

FZAA (FIH) – N'Djili International Airport – Kinshasa
FZAB (NLO) – N'Dolo Airport – Kinshasa
FZAJ (BOA) – Boma Airport – Boma
FZAL (LZI) – Luozi Airport – Luozi
FZAM (MAT) – Tshimpi Airport – Matadi
FZAR (NKL) – Nkolo-Fuma Airport – Nkolo-Fuma
FZBA (INO) – Inongo Airport – Inongo
FZBI (NIO) – Nioki Airport – Nioki
FZBO (FDU) – Bandundu Airport – Bandundu
FZBT (KRZ) – Kiri Airport – Kiri
FZCA (KKW) – Kikwit Airport – Kikwit
FZCB (IDF) – Idiofa Airport – Idiofa
FZCE (LUS) – Lusanga Airport – Lusanga
FZCV (MSM) – Masi-Manimba Airport – Masi-Manimba
FZDO (MNB) – Moanda Airport – Moanda
FZEA (MDK) – Mbandaka Airport – Mbandaka
FZEN (BSU) – Basankusu Airport – Basankusu
FZFA (LIE) – Libenge Airport – Libenge
FZFD (BDT) – Gbadolite Airport – Gbadolite
FZFK (GMA) – Gemena Airport – Gemena
FZFU (BMB) – Bumba Airport – Bumba
FZGA (LIQ) – Lisala Airport – Lisala
FZGN (BNB) – Boende Airport – Boende
FZGV (IKL) – Ikela Airport – Ikela
FZIC (FKI) – Bangoka International Airport – Kisangani
FZIR (YAN) – Yangambi Airport – Yangambi
FZJH (IRP) – Matari Airport – Isiro
FZKA (BUX) – Bunia Airport – Bunia
FZKJ (BZU) – Buta Zega Airport – Buta Zega
FZMA (BKY) – Kavumu Airport – Bukavu
FZNA (GOM) – Goma International Airport – Goma
FZNP (BNC) – Beni Airport – Beni
FZOA (KND) – Kindu Airport – Kindu
FZOD (KLY) – Kalima Airport – Kalima
FZOP (PUN) – Punia Airport – Punia
FZQA (FBM) – Lubumbashi International Airport – Lubumbashi
FZQC (PWO) – Pweto Airport – Pweto
FZQG (KEC) – Kasenga Airport – Kasenga
FZQM (KWZ) – Kolwezi Airport – Kolwezi
FZRA (MNO) – Manono Airport – Manono
FZRB (BDV) – Moba Airport – Moba
FZRF (FMI) – Kalemie Airport – Kalemie
FZRM (KBO) – Kabalo Airport – Kabalo
FZRQ (KOO) – Kongolo Airport – Kongolo
FZSA (KMN) – Base Airport – Kamina
FZSB (n/a) – Kamina Airport – Kamina
FZSK (KAP) – Kapanga Airport – Kapanga
FZTK (KNM) – Kaniama Airport – Kaniama
FZUA (KGA) – Kananga Airport – Kananga
FZUF (KGN) – Kasonga Airport – Kasonga
FZUG (LZA) – Luisa Airport – Luisa
FZUH (MMW) – Moma Airport – Moma
FZUK (TSH) – Tshikapa Airport – Tshikapa
FZVA (LJA) – Lodja Airport – Lodja
FZVI (LBO) – Lusambo Airport – Lusambo
FZVM (MEW) – Mweka Airport – Mweka
FZVR (BAN) – Basongo Airport – Basongo
FZWA (MJM) – Mbuji Mayi Airport – Mbuji Mayi
FZWC (GDJ) – Gandajika Airport – Gandajika


== References ==
"ICAO Location Indicators by State" (PDF). International Civil Aviation Organization. 2006-01-12. मूल से 26 सितंबर 2007 को पुरालेखित (PDF). अभिगमन तिथि 14 अप्रैल 2009."संयुक्त राष्ट्र Code for Trade and Transport Locations] [includes IATA codes". UN/LOCODE 2006-2. UNECE. 2007-04-30. मूल से 9 मई 2007 को पुरालेखित. अभिगमन तिथि 14 अप्रैल 2009.