revision: 5419206
title: Cymbopogon mandalaiaensis
url: https://hi.wikipedia.org/wiki/%E0%A4%A8%E0%A5%80%E0%A4%AC%E0%A5%82_%E0%A4%98%E0%A4%BE%E0%A4%B8


---

नींबू घास  (Cymbopogon या lemongrass) घास परिवार का पादप है जो एशिया, अफ्रीका और आस्ट्रेलिया के उष्णकटिबन्धीय क्षेत्रों में पाया जाता है।  नींबू घास की कुछ प्रजातियों का प्रयोग पाक शाला (खाना बनाने) में तथा दवाइयाँ बनाने मे भी किया जाता है। इस घास के पत्तियो का सुगंध नीबू जैसा लगता है। 


== प्रयोग ==
नींबू घास का प्रयोग सिट्रोनेला तेल (Ctronella_oil)बनाने मे किया जाता है। इस तेल का प्रयोग साबुन, सेंट, मच्छर भागने वाले अगरबत्ती बनाने मे किया जाता है। नींबू घास का प्रयोग चाय बनाने में भी किया जाता है। 


== चित्रावली ==

		
		


== प्रजातियाँ ==
Cymbopogon ambiguus Australian lemon-scented grass - Australia, Timor
Cymbopogon annamensis - Yunnan, Laos, Vietnam, Thailand
Cymbopogon bhutanicus - Bhutan
Cymbopogon bombycinus silky oilgrass - Australia
Cymbopogon caesius - Sub-Saharan Africa, Indian Subcontinent, Yemen, Afghanistan, Madagascar, Comoros, Réunion
Cymbopogon calcicola - Thailand, Kedah
Cymbopogon calciphilus - Thailand
Cymbopogon cambogiensis - Thailand, Cambodia, Vietnam
Cymbopogon citratus lemon grass (साँचा:Zh-cp) - Sri Lanka, northeast and southern India, Southeast Asia
Cymbopogon clandestinus - Thailand, Myanmar, Andaman Islands
Cymbopogon coloratus - 	मध्य प्रदेश, तमिलनाडु, म्यांमार, वियतनाम
Cymbopogon commutatus - Sahel, East Africa, Arabian Peninsula, Iraq, Iran, Afghanistan, India, Pakistan
Cymbopogon densiflorus - central + south-central Africa
Cymbopogon dependens - Australia
Cymbopogon dieterlenii - Lesotho, Namibia, South Africa
Cymbopogon distans - Gansu, Guizhou, Shaanxi, Sichuan, Tibet, Yunnan, Nepal, northern Pakistan, Jammu & Kashmir
Cymbopogon exsertus - Nepal, Assam
Cymbopogon flexuosus East Indian lemon grass - Indian Subcontinent, Indochina
Cymbopogon gidarba - Indian Subcontinent, Myanmar, Yunnan
Cymbopogon giganteus - Africa, Madagascar
Cymbopogon globosus - Maluku, New Guinea, Queensland
Cymbopogon goeringii - China incl Taiwan, Korea, Japan incl Ryukyu Islands, Vietnam
Cymbopogon gratus - Queensland
Cymbopogon jwarancusa - Socotra, Turkey, Middle East, Arabian Peninsula, Iraq, Iran, Afghanistan, Indian Subcontinent, Tibet, Sichuan, Yunnan, Vietnam
Cymbopogon khasianus - Yunnan, Guangxi, Assam, Bhutan, Bangladesh, Myanmar, Thailand
Cymbopogon liangshanensis - Sichuan
Cymbopogon mandalaiaensis - Myanmar
Cymbopogon marginatus - Cape Province of South Africa
Cymbopogon martini palmarosa - Indian Subcontinent, Myanmar, Vietnam
Cymbopogon mekongensis - China, Indochina
Cymbopogon microstachys Indian Subcontinent, Myanmar, Thailand, Yunnan
Cymbopogon microthecus - Nepal, Bhutan, Assam, West Bengal, Bangladesh
Cymbopogon minor - Yunnan
Cymbopogon minutiflorus -  Sulawesi
Cymbopogon nardus citronella grass (In Thai language ตะไคร้หอม (ta-khrai hom) - Indian Subcontinent, Indochina, central + southern Africa, Madagascar, Seychelles
Cymbopogon nervatus - Myanmar, Thailand, central Africa
Cymbopogon obtectus Silky-heads - Australia
Cymbopogon osmastonii - India, Bangladesh
Cymbopogon pendulus - Yunnan, eastern Himalayas, Myanmar, Vietnam
Cymbopogon polyneuros - Tamil Nadu, Sri Lanka, Myanmar
Cymbopogon pospischilii - eastern + southern Africa, Oman, Yemen, Himalayas, Tibet, Yunnan
Cymbopogon procerus - Australia, New Guinea, Maluku, Lesser Sunda Islands, Sulawesi
Cymbopogon pruinosus - islands of Indian Ocean
Cymbopogon queenslandicus - Queensland
Cymbopogon quinhonensis - Vietnam
Cymbopogon rectus - Lesser Sunda Islands, Java
Cymbopogon refractus barbed wire grass - Australia incl Norfolk Island
Cymbopogon schoenanthus camel hay or camel grass - Sahara, Sahel, eastern Africa, Arabian Peninsular, Iran
Cymbopogon tortilis - China incl Taiwan, Ryukyu + Bonin Is, Philippines, Vietnam, Maluku
Cymbopogon tungmaiensis - Sichuan, Tibet, Yunnan
Cymbopogon winterianus citronella grass - Borneo, Java, Sumatra
Cymbopogon xichangensis - SichuanFormerly includedNumerous species now regarded as better suited to other genera including Andropogon, Exotheca, Hyparrhenia, Iseilema, Schizachyrium, and Themeda.


== इन्हें भी देखें ==
भारतीय नीबू घास या मालाबार घास


== बाहरी कड़ियाँ ==
नींबू घास की खेती Archived 2013-07-11 at the Wayback Machineकिसानों की आमदनी को दोगुना करेगी ये फसल


== सन्दर्भ ==