revision: 4796607
title: Whangarei Airport
url: https://hi.wikipedia.org/wiki/%E0%A4%B5%E0%A4%BF%E0%A4%AE%E0%A4%BE%E0%A4%A8%E0%A4%95%E0%A5%8D%E0%A4%B7%E0%A5%87%E0%A4%A4%E0%A5%8D%E0%A4%B0%E0%A5%8B%E0%A4%82_%E0%A4%95%E0%A5%80_%E0%A4%B8%E0%A5%82%E0%A4%9A%E0%A5%80_ICAO_%E0%A4%95%E0%A5%8B%E0%A4%A1_%E0%A4%85%E0%A4%A8%E0%A5%81%E0%A4%B8%E0%A4%BE%E0%A4%B0:_N


---

Format of entries is:

ICAO (IATA) – Airport Name – Airport Location


== NC - Cook Islands ==
Also see airport category and list.

NCAI (AIT) – Aitutaki Airport (Araura Airport) – Aitutaki (Araura)
NCAT (AIU) – Enua Airport – Atiu (Enua Manu)
NCMG (MGS) – Mangaia Airport – Mangaia (Auau Enua)
NCMH (MHX) – Manihiki Island Airport – Manihiki (Humphrey Island)
NCMK (MUK) – Mauke Airport – Mauke (Akatoka Manava)
NCMR (MOI) – Mitiaro Airport (Nukuroa Airport) – Mitiaro (Nukuroa)
NCPY (PYE) – Tongareva Airport – Penrhyn Island (Tongareva)
NCRG (RAR) – Rarotonga International Airport – Avarua, Rarotonga


== NF - Fiji, Tonga ==


=== Fiji ===
Also see airport category and list.

NFCI – Cicia Airport – Cicia
NFCS (CST) – Castaway Island Airport – Castaway Island (Qalito), Mamanuca Islands
NFFA (BFJ) – Ba Airport – Ba, Viti Levu
NFFN (NAN) – Nadi International Airport – Nadi, Viti Levu
NFFO (PTF) – Malolo Lailai Airport – Malolo Lailai
NFFR (RBI) – Rabi Airport – Rabi
NFKD (KDV) – Vunisea Airport – Vunisea (Namalata), Kadavu
NFMA (MNF) – Mana Island Airport – Mana Island
NFMO (MFJ) – Moala Airport – Moala
NFNA (SUV) – Nausori International Airport – Suva, Viti Levu
NFNB (LEV) – Levuka Airfield – Bureta
NFND (PHR) – Pacific Harbour / Deumba SPB – Pacific Harbour / Deuba, Viti Levu
NFNG (NGI) – Ngau Airport – Ngau (Gau), Ngau Island
NFNH (LUC) – Laucala Airport – Laucala Island (Lauthala Island)
NFNK (LKB) – Lakemba Airport – Lakeba (Lakemba)
NFNL (LBS) – Lambasa Airport – Labasa (Lambasa), Vanua Levu
NFNM (TVU) – Taveuni Island Airport – Matei, Taveuni
NFNO (KXF) – Koro Airport – Koro
NFNR (RTA) – Rotuma Island Airport – Rotuma
NFNS (SVU) – Savu Savu Airport – Savu Savu
NFNU (BVF) – Bua Airport – Bua, Vanua Levu
NFNV (VAU) – Vatukoula Airport – Vatukoula, Viti Levu
NFNW (KAY) – Wakaya Airport – Wakaya
NFOL (ONU) – Ono-i-Lau Airport – Ono-i-Lau
NFSW (YAS) – Yasawa Airport – Yasawa
NFVB (VBV) – Vanuabalavu Airport – Vanua Balavu (Vanuabalavu)
NFVL (VTF) – Vatulele Airport – Vatulele


=== Tonga ===
Also see airport category and list.

NFTE (EUA) – Eua Airport – Eua
NFTF (TBU) – Fuaʻamotu International Airport – Nukuʻalofa, Tongatapu
NFTL (HPA) – Lifuka Island Airport (Salote Pilolevu Airport) – Lifuka, Ha'apai
NFTO (NFO) – Mata'aho Airport – Niuafo'ou
NFTP (NTT) – Niuatoputapu Airport (Kuini Lavenia Airport) – Niuatoputapu
NFTV (VAV) – Vava'u International Airport (Lupepau'u Airport) – Vava'u


== NG - Kiribati (Gilbert Islands), Tuvalu ==


=== Kiribati ===
Also see airport category and list.

NGAB (ABF) – Abaiang Atoll Airport – Abaiang
NGBR (BEZ) – Beru Island Airport – Beru Island
NGKT (KUC) – Kuria Airport – Kuria
NGMA (MNK) – Maiana Airport – Maiana
NGMK (MZK) – Marakei Airport – Marakei
NGMN (MTK) – Makin Airport – Makin
NGNU (NIG) – Nikunau Airport – Nikunau
NGON (OOT) – Onotoa Airport – Onotoa
NGTA (TRW) – Bonriki International Airport – Tarawa
NGTB (AEA) – Abemama Atoll Airport – Abemama
NGTE (TBF) – Tabiteuea North Airport – Tabiteuea North
NGTM (TMN) – Tamana Airport – Tamana
NGTO (NON) – Nonouti Airport – Nonouti
NGTR (AIS) – Arorae Island Airport – Arorae
NGTS (TSU) – Tabiteuea South Airport – Tabiteuea South
NGTU (BBG) – Butaritari Atoll Airport – Butaritari
NGUK (AAK) – Aranuka Airport – Aranuka


=== Tuvalu ===
Also see airport category and list.

NGFU (FUN) – Funafuti International Airport – Funafuti


== NI - Niue ==
Also see airport category and list.

NIUE (IUE) – Niue Hanan International Airport – Alofi


== NL - Wallis and Futuna ==
Also see airport category and list.

NLWF (FUT) – Futuna - Pointe Vele Airport (Maopoop Airport) – Futuna Island
NLWW (WLS) – Hihifo Airport – Wallis Island


== NS - Samoa, American Samoa ==


=== Samoa ===
Also see airport category and list.

NSAU (AAU) – Asau Airport – Asau
NSFA (APW) – Faleolo International Airport – Apia
NSFI (FGI) – Fagali'i Airport – Fagali'i
NSMA (MXS) – Maota Airport – Maota


=== American Samoa ===
Also see airport category and list.

NSFQ (FAQ) – Fitiuta Airport – Fitiuta
NSTU (PPG) – Pago Pago International Airport (Tutuila Intl) – Pago Pago


== NT - French Polynesia ==
Also see airport category and list.

NTAA (PPT) – Faa'a International Airport – Faa'a, Tahiti
NTAR (RUR) – Rurutu Airport – Rurutu, Austral Islands
NTAT (TUB) – Tubuai Airport – Tubuai, Austral Islands
NTGA (AAA) – Anaa Airport – Anaa, Tuamotus
NTGB (FGU) – Fangatau Airport – Fangatau, Tuamotus
NTGC (TIH) – Tikehau Airport – Tikehau
NTGD (APK) – Apataki Airport – Apataki, Tuamotus
NTGE (REA) – Reao Island Airport – Reao, Tuamotus
NTGF (FAV) – Fakarava Airport – Fakarava
NTGH (HHZ) – Hikueru Airport – Hikueru, Tuamotus
NTGI (XMH) – Manihi Airport – Manihi, Tuamotus
NTGJ (GMR) – Totegegie Airport – Totegegie, Gambier Islands
NTGK (KKR) – Kaukura Airport – Kaukura Atoll
NTGM (MKP) – Makemo Airport – Makemo, Tuamotus
NTGN (NAU) – Napuka Airport – Napuka, Disappointment Islands
NTGO (TKV) – Tatakoto Airport – Tatakoto
NTGP (PKP) – Puka-Puka Airport – Puka-Puka, Tuamotus
NTGQ (PUK) – Pukarua Airport – Pukarua, Tuamotus
NTGT (TKP) – Takapoto Airport – Takapoto, Tuamotus
NTGU (AXR) – Arutua Airport – Arutua
NTGV (MVT) – Mataiva Airport – Mataiva, Tuamotus
NTGW (NUK) – Nukutavake Airport – Nukutavake
NTKH (FHZ) – Fakahina Airport – Fakahina
NTKN (...) – Niau Airport – Niau
NTKR (TKX) – Takaroa Airport – Takaroa
NTMD (NHV) – Nuku-Hiva Airport – Nuku Hiva, Marquesas Islands
NTMN (HIX) – Atuona Airport – Hiva Oa, Marquesas Islands
NTMP (UAP) – Ua Pou Airport – Marquesas Islands
NTMU (UAH) – Ua-Huka Airport – Ua Huka, Marquesas Islands
NTTB (BOB) – Bora Bora Airport (Motu-Mute Airport) – Bora Bora, located on Moto Mute
NTTE (TTI) – Tetiaroa Airport – Society Islands
NTTG (RGI) – Rangiroa Airport – Rangiroa, Tuamotus
NTTH (HUH) – Fare Airport – Huahine, Leeward Islands (Society Islands)
NTTM (MOZ) – Temae Airport – Moorea, Windward Islands (Society Islands)
NTTO (HOI) – Hao Airport – Hao Island
NTTP (MAU) – Maupiti Airport – Maupiti
NTTR (RFP) – Uturoa Airport – Raiatea, Society Islands
NTUV (VHZ) – Vahitahi Airport – Vahitahi


== NV - Vanuatu ==
Also see airport category and list.

NVSC (SLH) – Vanua Lava Island Airport – Sola
NVSE – Siwo Airport – Émaé
NVSF (CCV) – Craig Cove Airport – Craig Cove
NVSG (LOD) – Longana Airport – Longana
NVSH (SSR) – Sara Airport – Sara
NVSL (LPM) – Malekoula Island Airport – Lamap
NVSM (LNB) – Lamen Bay Airport – Lamen-Bay
NVSN (MWF) – Maewo-Naone Airport – Maewo-Naone
NVSO (LNE) – Lonorore Airport – Lonorore
NVSP (NUS) – Norsup Airport – Norsup
NVSR (RCL) – Redcliff Airport – Redcliff
NVSS (SON) – Santo-Pekoa International Airport – Luganville, Espiritu Santo
NVST (TGH) – Tongoa Airport – Tongoa
NVSU (ULB) – Ulei Airport – Ulei
NVSV (VLS) – Valesdir Airport – Valesdir
NVSW (WLH) – Walaha Airport – Walaha
NVSX (SWJ) – South West Bay Airport – South West Bay
NVVB (AWD) – Aniwa Airport – Aniwa
NVVD (DLY) – Dillon’s Bay Airport – Dillon's Bay
NVVF (FTA) – Futuna Airport – Futuna
NVVI (IPA) – Ipota Airport – Ipota
NVVQ (UIQ) – Quoin Hill Airport – Quoin Hill
NVVV (VLI) – Bauerfield International Airport – Port Vila
NVVW (TAH) – White Grass Airport – Tanna


== NW - New Caledonia ==
Also see airport category and list.

NWWA (TGJ) – Tiga Airport – Tiga Island
NWWC (BMY) – Belep Islands Airport – Waala, Belep
NWWD (KNQ) – Kone Airport – Koné
NWWE (ILP) – Moue Airport – L'Île-des-Pins
NWWH (HLU) – Nesson Airport – Houailou
NWWK (KOC) – Koumac Airport – Koumac
NWWL (LIF) – Ouanaham Airport (Wanaham Airport) – Lifou
NWWM (GEA) – Nouméa Magenta Airport – Nouméa
NWWO (IOU) – Ile Ouen/Edmond Cane Airport – Ile Ouen
NWWP (PUV) – Poum Airport – Poum
NWWQ (PDC) – Nickel Airport – Mueo
NWWR (MEE) – La Roche Airport – Maré
NWWU (TOU) – Touho Airport – Touho
NWWV (UVE) – Ouloup Airport – Ouvéa
NWWW (NOU) – La Tontouta International Airport – Nouméa


== NZ - New Zealand ==
Also see airport category and list.

NZAA (AKL) – Auckland Airport – Auckland
NZAL – Avalon Heliport – Lower Hutt, Wellington
NZAP (TUO) – Taupo Airport – Taupo
NZAR (AMZ) – Ardmore Airport – Auckland
NZAS (ASG) – Ashburton Aerodrome – Ashburton
NZAU – Waiouru Airfield – Waiouru
NZBA – Balclutha Aerodrome – Balclutha
NZBC – ASB Bank Centre Heliport – Auckland
NZBW – Burwood Hospital Heliport – Christchurch
NZCH (CHC) – Christchurch International Airport – Christchurch
NZCI (CHT) – Chatham Islands / Tuuta Airport – Chatham Islands
NZCS – Cromwell Racecourse Aerodrome – Cromwell
NZCX (CMV) – Coromandel Aerodrome – Coromandel Peninsula, North Island
NZDA (DGR) – Dargaville Aerodrome – Dargaville
NZDC – Dunedin City Heliport – Dunedin
NZDH – Dunedin Hospital Heliport – Dunedin
NZDN (DUD) – Dunedin International Airport – Mosgiel, Dunedin
NZDV – Dannevirke Aerodrome – Dannevirke
NZFF – Forest Field Aerodrome – Rangiora
NZFI – Feilding Aerodrome – Feilding
NZFJ – Franz Josef Aerodrome – Franz Josef Village
NZFP – Foxpine Aerodrome – Foxton
NZGA – Galatea Aerodrome – Galatea
NZGB (GBZ) – Great Barrier Aerodrome – Great Barrier Island
NZGC – Gore Aerodrome – Gore
NZGI – Garden City Heliport – Christchurch
NZGM (GMN) – Greymouth Aerodrome – Greymouth
NZGR – Great Mercury Aerodrome – Great Mercury Island
NZGS (GIS) – Gisborne Airport – Gisborne
NZGT (GTN) – Glentanner Aerodrome – Lake Pukaki
NZGY – Glenorchy Aerodrome – Glenorchy
NZHA – Hawera Aerodrome – Hawera
NZHK (HKK) – Hokitika Aerodrome – Hokitika
NZHN (HLZ) – Hamilton International Airport – Hamilton
NZHR – Hanmer Springs Aerodrome – Hanmer Springs
NZHS – Hastings Aerodrome – Hastings
NZHT – Haast Aerodrome – Haast
NZIR – McMurdo Sea ice runway – Antarctica
NZJA – Tauranga Hospital Heliport – Tauranga
NZJC – Christchurch Hospital Heliport – Christchurch
NZJE – Dargaville Hospital Heliport – Dargaville
NZJG – Gisborne Hospital Heliport – Gisborne
NZJH – Hastings Hospital Heliport – Hastings
NZJI – Bay of Islands Heliport – Kerikeri
NZJK – Kaitaia Hospital Heliport – Kaitaia
NZJL – Auckland Hospital Heliport – Auckland
NZJM – Palmerston North Hospital Heliport – Palmerston North
NZJO – Rotorua Hospital Heliport – Rotorua
NZJQ – Taranaki Base Hospital Heliport – New Plymouth
NZJR – Whangarei Hospital Heliport – Whangarei
NZJS – Southland/Kew Hospital Heliport – Invercargill
NZJT – Taumarunui Hospital Heliport – Taumarunui
NZJU – Wanganui Hospital Heliport – Wanganui
NZJY – Wairoa Hospital Heliport – Wairoa
NZJZ – Taupo Hospital Heliport – Taupo
NZKE – Waiheke Island Aerodrome – Waiheke Island
NZKF – Kaipara Flats Aerodrome – Kaipara District
NZKI (KBZ) – Kaikoura Aerodrome – Kaikoura
NZKK (KKE) – Kerikeri/Bay of Islands Airport – Kerikeri / Bay of Islands
NZKM – Karamea Aerodrome – Karamea
NZKO (KKO) – Kaikohe Aerodrome – Kaikohe
NZKT (KAT) – Kaitaia Airport – Kaitaia
NZLT – Lake Taupo Water – Lake Taupo
NZLX (ALR) – Alexandra Aerodrome – Alexandra
NZMA (MTA) – Matamata Aerodrome – Matamata
NZMB – Mechanics Bay Heliport – Auckland
NZMC (MON) – Mount Cook Aerodrome – Aoraki/Mount Cook
NZME – Mercer Aerodrome – Mercer
NZMF (MFN) – Milford Sound Airport – Milford Sound
NZMH – Masterton Hospital Heliport – Masterton
NZMK (MZP) – Motueka Aerodrome – Motueka
NZMO (TEU) – Manapouri Aerodrome – Te Anau / Manapouri
NZMR – Murchison Aerodrome – Murchison
NZMS (MRO) – Masterton Aerodrome – Masterton
NZMT – Martinborough Aerodrome – Martinborough
NZMW – Makarora Aerodrome – Makarora
NZNE – North Shore Aerodrome – Auckland
NZNH – Nelson Hospital Heliport – Nelson
NZNP (NPL) – New Plymouth Airport – New Plymouth
NZNR (NPE) – Napier Airport – Napier
NZNS (NSN) – Nelson Airport – Nelson
NZNV (IVC) – Invercargill Airport – Invercargill
NZOA – Omarama Aerodrome – Omarama
NZOH (OHA) – Ohakea Airbase (RNZAF) – Ohakea
NZOM – Omaka Aerodrome – Blenheim
NZOP – Opotiki Aerodrome – Opotiki
NZOU (OAM) – Oamaru Aerodrome – Oamaru
NZPA – Paihia Heliport – Paihia
NZPG – Pegasus blue ice runway – Antarctica
NZPI – Parakai Aerodrome – Parakai
NZPM (PMR) – Palmerston North International Airport – Palmerston North
NZPN (PCN) – Picton Aerodrome – Picton - Koromiko
NZPP (PPQ) – Paraparaumu Airport – Paraparaumu
NZQN (ZQN) – Queenstown Airport – Queenstown
NZQW – Queens Wharf Heliport – Wellington
NZRA (RAG) – Raglan Aerodrome – Raglan
NZRC (SZS) – Ryans Creek Aerodrome – Half Moon Bay, Stewart Island
NZRK – Rangitaiki Aerodrome – Rangitaiki
NZRO (ROT) – Rotorua Airport – Rotorua
NZRT – Rangiora Aerodrome – Rangiora
NZRU – Waiouru Airbase (NZ Army) – Waiouru
NZRW – Ruawai Aerodrome – Ruawai
NZRX – Roxburgh Aerodrome – Roxburgh
NZSD – Stratford Aerodrome – Stratford
NZSP – Amundsen-Scott South Pole Station – Antarctica
NZTG (TRG) – Tauranga Airport – Tauranga
NZTH (TMZ) – Thames Aerodrome – Thames
NZTK (KTF) – Takaka Aerodrome – Takaka
NZTL – Tekapo Aerodrome – Tekapo
NZTM – Taumarunui Aerodrome – Taumarunui
NZTN – Turangi Aerodrome – Turangi
NZTO (TKZ) – Tokoroa Aerodrome – Tokoroa
NZTT – Te Kuiti Aerodrome – Te Kuiti
NZTU (TIU) – Richard Pearse Airport – Timaru
NZTZ – Te Anau Aerodrome – Te Anau
NZUK (TWZ) – Pukaki Aerodrome – Twizel
NZUN – Pauanui Beach Aerodrome – Pauanui
NZVL – Mandeville Aerodrome – Mandeville, Gore
NZVR – Taihape Aerodrome – Taihape
NZWB (BHE) – Woodbourne Airport – Blenheim (ICAO code also listed as NZBM)
NZWD – Williams Field – Antarctica
NZWF (WKA) – Wanaka Airport – Wanaka
NZWG – Wigram Aerodrome – Wigram, Christchurch closed March 1, 2009
NZWH – Wellington Hospital Heliport – Wellington
NZWK (WHK) – Whakatane Aerodrome – Whakatane
NZWM – Waimate Aerodrome – Waimate
NZWN (WLG) – Wellington International Airport – Wellington
NZWO (WIR) – Wairoa Aerodrome – Wairoa
NZWP – RNZAF Base Auckland – Auckland
NZWR (WRE) – Whangarei Airport – Whangarei
NZWL (WML) – West Melton Aerodrome – West Melton
NZWS (WSZ) – Westport Airport – Westport
NZWT (WTZ) – Whitianga Aerodrome – Whitianga
NZWU (WAG) – Wanganui Airport – Wanganui
NZWV – Waihi Beach Aerodrome – Waihi Beach
NZYP – Waipukurau Aerodrome – Waipukurau


== References ==
"ICAO Location Indicators by State" (PDF). International Civil Aviation Organization. 2006-01-12. मूल से 26 सितंबर 2007 को पुरालेखित (PDF). अभिगमन तिथि 14 अप्रैल 2009."संयुक्त राष्ट्र Code for Trade and Transport Locations] [includes IATA codes". UN/LOCODE 2006-2. UNECE. 2007-04-30. मूल से 9 मई 2007 को पुरालेखित. अभिगमन तिथि 14 अप्रैल 2009.