revision: 4796606
title: Cuernavaca, Morelos
url: https://hi.wikipedia.org/wiki/%E0%A4%B5%E0%A4%BF%E0%A4%AE%E0%A4%BE%E0%A4%A8%E0%A4%95%E0%A5%8D%E0%A4%B7%E0%A5%87%E0%A4%A4%E0%A5%8D%E0%A4%B0%E0%A5%8B%E0%A4%82_%E0%A4%95%E0%A5%80_%E0%A4%B8%E0%A5%82%E0%A4%9A%E0%A5%80_ICAO_%E0%A4%95%E0%A5%8B%E0%A4%A1_%E0%A4%85%E0%A4%A8%E0%A5%81%E0%A4%B8%E0%A4%BE%E0%A4%B0:_M


---

Format of entries is:

ICAO (IATA) – Airport Name – Airport Location


== MB - Turks and Caicos Islands ==
Also see airport category and list.

MBGT (GDT) – JAGS McCartney International Airport (Grand Turk Int'l) – Grand Turk Island
MBMC (MDS) – Middle Caicos Airport – Middle Caicos
MBNC (NCA) – North Caicos Airport – North Caicos
MBPI (PIC) – Pine Cay Airport – Pine Cay
MBPV (PLS) – Providenciales International Airport – Providenciales
MBSC (XSC) – South Caicos Airport – South Caicos
MBSY (SLX) – Salt Cay Airport – Salt Cay
MBAC (XXX) – Harold Charles International Airport – Ambergris Cay


== MD - Dominican Republic ==
Also see airport category and list.

MDAB (EPS) – Arroyo Barril International Airport – Samaná
MDBH (BRX) – María Montez International Airport – Barahona
MDCR (CBJ) – Cabo Rojo Airport – Pedernales
MDCZ (COZ) – Constanza Airport – Constanza
MDCY (AZS) – Samaná El Catey International Airport – Samaná
MDHE (HEX) – Herrera International Airport – Santo Domingo (closed February 2006)
MDJB (JBQ) – La Isabela International Airport (Dr. Joaquín Balaguer) – Santo Domingo
MDLR (LRM) – La Romana International Airport – La Romana
MDPC (PUJ) – Punta Cana International Airport – Punta Cana / Higüey
MDPO (EPS) – El Portillo Airport – Samaná
MDPP (POP) – Gregorio Luperón International Airport – Puerto Plata
MDSB (SNX) – Sabana de la Mar Airport – Sabana de la Mar
MDSD (SDQ) – Las Américas-JFPG International Airport (Dr. José Fco. Peña Gómez) – Punta Caucedo (near Santo Domingo)
MDSI (ZXD) – San Isidro Air Base – San Isidro
MDSJ (SJM) – San Juan de la Maguana Airport – San Juan de la Maguana
MDST (STI) – Cibao International Airport (Santiago Municipal) – Santiago


== MG - Guatemala ==
Also see airport category and list.

MGBN – Bananera Airport – Bananera, Izabal
MGCB (CBV) – Cobán Airport – Cobán, Alta Verapaz
MGCR (CMM) – Carmelita Airport – Carmelita, El Petén
MGCT (CTF) – Coatepeque Airport – Coatepeque, Quetzaltenango
MGES – Esquipulas Airport – Esquipulas, Chiquimula
MGGT (GUA) – La Aurora International Airport – Guatemala City – Guatemala
MGHT (HUG) – Huehuetenango Airport – Huehuetenango, Huehuetenango
MGLL – La Libertad Airport – La Libertad, El Petén
MGML – Malacatan Airport – Malacatan, San Marcos
MGMM (MCR) – Melchor de Mencos Airport – Melchor de Mencos, El Petén
MGPB (PBR) – Puerto Barrios Airport – Puerto Barrios, Izabal
MGPP (PON) – Poptun Airport – Poptún, El Petén
MGQC (AQB) – Quiché Airport – Quiché, El Quiché
MGQZ (AAZ) – Quetzaltenango Airport – Quetzaltenango, Quetzaltenango
MGRB (RUV) – Rubelsanto Airport – Rubelsanto, Alta Verapaz
MGRT (RER) – Retalhuleu Airport / Base Aérea del Sur – Retalhuleu, Retalhuleu
MGSJ – San José Airport – Puerto San José, Escuintla
MGSM – San Marcos Airport – San Marcos, San Marcos
MGTK (FRS) – Mundo Maya International Airport (Santa Elena) – Flores, El Petén
MGZA – Zacapa Airport – Zacapa, Zacapa


== MH - Honduras ==
Also see airport category and list.

MHAM – Amapala Airport (Los Pelonas) – Amapala
MHCA (CAA) – Catacamas Airport – Catacamas
MHCC – Cenamer ACC/FIC – Cenamer
MHCG – Comayagua Airport – Comayagua
MHCH – Choluteca Airport – Choluteca
MHCT – Puerto Castilla Airport – Puerto Castilla
MHDU – Mocorón Airport (Durzona) – Mocorón
MHIC – Isla del Cisne Airport – Isla del Cisne
MHJU (JUT) – Juticalpa Airport – Juticalpa
MHLC (LCE) – Golosón International Airport – La Ceiba
MHLE (LEZ) – La Esperanza Airport – La Esperanza
MHLM (SAP) – Ramón Villeda Morales International Airport – La Mesa (near San Pedro Sula) (MHSP)
MHMA (MRJ) – Marcala Airport – Marcala
MHNJ (GJA) – Guanaja Airport – Guanaja
MHNV – Nuevo Ocotepeque Airport – Nuevo Ocotepeque
MHOA (OAN) – Olanchito Airport – Olanchito
MHPE – El Progreso Airport – El Progreso
MHPL (PEU) – Puerto Lempira Airport – Puerto Lempira
MHPU – Puerto Cortes Airport – Puerto Cortes
MHRO (RTB) – Juan Manuel Gálvez International Airport (Roatán Intl) – Roatán
MHRU (RUY) – Ruinas de Copan Airport – Ruinas de Copan
MHSB – Santa Bárbara Airport – Santa Bárbara (MHSZ)
MHSC (XPL) – Palmerola Air Base (Coronel Enrique Soto Cano Air Base) – Comayagua (MHPA/ENQ)
MHSR (SDH) – Santa Rosa de Copán Airport – Santa Rosa de Copán
MHTG (TGU) – Toncontín International Airport – Tegucigalpa
MHTJ (TJI) – Trujillo Airport – Trujillo
MHTL (TEA) – Tela Airport – Tela (MHTE)
MHUT (UII) – Útila Airport – Útila
MHYR (ORO) – Yoro Airport – Yoro


== MK - Jamaica ==
Also see airport category and list.

MKBS (OCJ) – Boscobel Aerodrome – Ocho Rios
MKJP (KIN) – Norman Manley International Airport – Kingston
MKJS (MBJ) – Sangster International Airport – Montego Bay
MKKJ (POT) – Ken Jones Airport – Port Antonio
MKNG (NEG) – Negril Airport – Negril
MKTP (KTP) – Tinson Pen Airport – Kingston


== MM - Mexico ==
Also see airport category and list.

MMAA (ACA) – General Juan N. Álvarez International Airport – Acapulco, Guerrero
MMAS (AGU) – Lic. Jesús Terán Peredo International Airport – Aguascalientes, Aguascalientes
MMBT (HUX) – Bahías de Huatulco International Airport – Huatulco, Oaxaca
MMCB (CVJ) – General Mariano Matamoros Airport – Cuernavaca, Morelos
MMCE (CME) – Ciudad del Carmen International Airport – Ciudad del Carmen, Campeche
MMCL (CUL) – Federal de Bachigualato International Airport – Culiacán, Sinaloa
MMCM (CTM) – Chetumal International Airport – Chetumal, Quintana Roo
MMCN (CEN) – Ciudad Obregón International Airport – Ciudad Obregón, Sonora
MMCP (CPE) – Ing. Alberto Acuña Ongay International Airport – Campeche, Campeche
MMCS (CJS) – Abraham González International Airport – Ciudad Juárez, Chihuahua
MMCU (CUU) – General Roberto Fierro Villalobos International Airport – Chihuahua, Chihuahua
MMCV (CVM) – General Pedro J. Méndez National Airport – Ciudad Victoria, Tamaulipas
MMCY (CYW) – Captain Rogelio Castillo National Airport – Celaya, Guanajuato
MMCZ (CZM) – Cozumel International Airport – Cozumel, Quintana Roo
MMDO (DGO) – General Guadalupe Victoria International Airport – Durango, Durango
MMEP (TPQ) – Amado Nervo National Airport – Tepic, Nayarit
MMES (ESE) – Ensenada Airport – Ensenada, Baja California
MMGL (GDL) – Don Miguel Hidalgo y Costilla International Airport – Guadalajara, Jalisco
MMGM (GYM) – General José María Yáñez International Airport – Guaymas, Sonora
MMGR (GUB) – Guerrero Negro Airport – Guerrero Negro, Baja California Sur
MMHO (HMO) – General Ignacio Pesqueira Garcia International Airport – Hermosillo, Sonora
MMIA (CLQ) – Lic. Miguel de la Madrid Airport – Colima, Colima
MMIO (SLW) – Plan de Guadalupe International Airport – Saltillo, Coahuila
MMJA (JAL) – El Lencero Airport – Jalapa (Xalapa), Veracruz
MMLC (LZC) – Lázaro Cárdenas Airport – Lázaro Cárdenas, Michoacán
MMLM (LMM) – Federal del Valle del Fuerte International Airport – Los Mochis, Sinaloa
MMLO (BJX) – Aeropuerto Internacional de Guanajuato (known as Del Bajío) – Silao, Guanajuato
MMLP (LAP) – Manuel Márquez de León International Airport – La Paz, Baja California Sur
MMLT (LTO) – Loreto International Airport – Loreto, Baja California Sur
MMMA (MAM) – General Servando Canales International Airport – Matamoros, Tamaulipas
MMMD (MID) – Manuel Crescencio Rejón International Airport – Mérida, Yucatán
MMML (MXL) – General Rodolfo Sánchez Taboada International Airport – Mexicali, Baja California
MMMM (MLM) – General Francisco J. Mujica International Airport – Morelia, Michoacán
MMMT (MTT) – Minatitlán/Coatzacoalcos National Airport – Minatitlán, Veracruz
MMMV (LOV) – Venustiano Carranza International Airport – Monclova, Coahuila
MMMX (MEX) – Lic. Benito Juárez International Airport – Mexico City, Distrito Federal
MMMY (MTY) – General Mariano Escobedo International Airport – Monterrey, Nuevo León
MMMZ (MZT) – General Rafael Buelna International Airport – Mazatlán, Sinaloa
MMNL (NLD) – Quetzalcóatl International Airport – Nuevo Laredo, Tamaulipas
MMOX (OAX) – Xoxocotlán International Airport – Oaxaca, Oaxaca
MMPA (PAZ) – El Tajín National Airport – Poza Rica, Veracruz
MMPB (PBC) – Hermanos Serdán International Airport – Puebla, Puebla
MMPG (PDS) – Piedras Negras International Airport – Piedras Negras, Coahuila
MMPN (UPN) – Lic. y Gen. Ignacio López Rayón Airport – Uruapan, Michoacán
MMPR (PVR) – Lic. Gustavo Díaz Ordaz International Airport – Puerto Vallarta, Jalisco
MMPS (PXM) – Puerto Escondido International Airport – Puerto Escondido, Oaxaca
MMQT (QRO) – Ing. Fernando Espinoza Gutiérrez International Airport – Querétaro, Querétaro
MMRX (REX) – General Lucio Blanco International Airport – Reynosa, Tamaulipas
MMSD (SJD) – Los Cabos International Airport – Los Cabos, Baja California Sur
MMSL (CSL) – Cabo San Lucas International Airport – Cabo San Lucas, Baja California Sur
MMSP (SLP) – Ponciano Arriaga International Airport – San Luis Potosí, San Luis Potosí
MMTC (TRC) – Francisco Sarabia International Airport a.k.a. Torreón International Airport – Torreón, Coahuila
MMTG (TGZ) – Francisco Sarabia National Airport a.k.a. Angel Albino Corzo Airport –Tuxtla Gutiérrez, Chiapas
MMTJ (TIJ) – General Abelardo L. Rodríguez International Airport – Tijuana, Baja California
MMTM (TAM) – General Francisco Javier Mina International Airport – Tampico, Tamaulipas
MMTN (TSL) – Tamuín National Airport – Tamuín, San Luis Potosí
MMTO (TLC) – Lic. Adolfo López Mateos International Airport – Toluca, Estado de México
MMTP (TAP) – Tapachula International Airport – Tapachula, Chiapas
MMUN (CUN) – Cancún International Airport – Cancún, Quintana Roo
MMVA (VSA) – Carlos Rovirosa Pérez International Airport – Villahermosa, Tabasco
MMVR (VER) – General Heriberto Jara International Airport – Veracruz, Veracruz
MMZC (ZCL) – General Leobardo C. Ruiz International Airport a.k.a. La Calera Airport – Zacatecas, Zacatecas
MMZH (ZIH) – Ixtapa-Zihuatanejo International Airport – Ixtapa-Zihuatanejo, Guerrero
MMZO (ZLO) – Playa de Oro International Airport – Manzanillo, Colima


== MN - Nicaragua ==
Also see airport category and list.

MNAL – Alamikamba Airport – Alamikamba, RAAN (Zelaya)
MNAM – Altmira Airport – Altmira, Boaco
MNBC – Boaco Airport – Boaco, Boaco
MNBL (BEF) – Bluefields Airport – Bluefields, RAAS (Zelaya)
MNBR – Los Brasiles Airport – Los Brasiles, Managua
MNBZ (BZA) – Bonanza Airport (San Pedro) – Bonanza, RAAN (Zelaya)
MNCH – Chinandega Airport – Chinandega, Chinandega
MNCI (RNI) – Corn Island Airport – Corn Island, RAAS (Zelaya)
MNCT – Corinto Airport – Corinto, Chinandega
MNDM – Dos Montes Airport – Dos Montes, León
MNEP – La Esperanza Airport – La Esperanza, RAAS (Zelaya)
MNES – Estelí Airport – Estelí, Estelí
MNFC – Punta Huete Airport (Panchito) – Punta Huete, Managua
MNFF – El Bluff Airport – El Bluff, RAAS (Zelaya)
MNFM – Fertimar Airport – Fertimar, Chontales
MNHG – Hato Grande Airport – Hato Grande, Chontales
MNJG – Jinotega Airport – Jinotega, Jinotega
MNJU – Juigalpa Airport – Juigalpa, Chontales
MNKW – Karawala Airport – Karawala, RAAS (Zelaya)
MNLL – Las Lajas Airport – Las Lajas, Granada
MNLN – León Airport (Fanor Urroz) – León, León
MNLP – La Paloma Airport – La Paloma, Rivas
MNMA – Macantaca Airport – Macantaca (Makantaca), RAAN (Zelaya)
MNMG (MGA) – Managua International Airport (Augusto Cesar Sandino Intl) – Managua, Managua
MNMR – Montelimar Airport – Montelimar, Managua
MNNG (NVG) – Nueva Guinea Airport – Nueva Guinea, RAAS (Zelaya)
MNPC (PUZ) – Puerto Cabezas Airport – Puerto Cabezas, RAAN (Zelaya)
MNPP – El Papalonal Airport – El Papalonal, León
MNPR – Palo Ralo Airport – Palo Ralo, Río San Juan
MNRS – Rivas Airport – Rivas, Rivas
MNRT – Rosita Airport – Rosita, RAAN (Zelaya)
MNSC – San Carlos Airport – San Carlos, Río San Juan
MNSI (SIU) – Siuna Airport – Siuna, RAAN (Zelaya)
MNWP (WSP) – Waspam Airport – Waspam, RAAN (Zelaya)


== MP - Panama ==
Also see airport category and list.

MPBO (BOC) – Bocas del Toro "Isla Colon" International Airport – Bocas del Toro
MPCE (CTD) – Herrera Alonso Valderrama Airport – Chitre
MPCH (CHX) – Captain Manuel Niño International Airport – Changuinola
MPDA (DAV) – Enrique Malek International Airport – David
MPEJ (ONX) – Enrique Adolfo Jiménez Airport – Colón
MPFS – Fort Sherman – Fuerte Sherman
MPHO (BLB) – Howard Air Force Base – Balboa
MPJE (JQE) – Jaque Airport – Jaque
MPLB – Albrook AFS – Balboa
MPLP (PLP) – Captain Ramon Xatruch Airport – La Palma
MPMG (PAC) – Albrook "Marcos A. Gelabert" International Airport – Panama City
MPNU – Augusto Vergara Airport – Los Santos
MPOA (PUE) – Puerto Obaldia Airport – Puerto Obaldia
MPRH – Captain Scarlet Martinez Airport – Rio Hato
MPSA (SYP) – Ruben Cantu Airport – Santiago
MPTO (PTY) – Tocumen International Airport – Panama City
MPVR (PVE) – El Porvenir Airport – El Porvenir
MPWN (NBL) – San Blas Airport – Wannukandi


== MR - Costa Rica ==
Also see airport category and list.

MRAN (FON) – La Fortuna Airport – La Fortuna
MRAO (TTQ) – Tortuguero Airport – Tortuguero
MRBA (BAI) – Buenos Aires Airport – Buenos Aires
MRBC (BCL) – Barra del Colorado Airport – Barra del Colorado
MRCA (CSC) – Codela Airport – Cañas
MRCC (OTR) – Coto 47 Airport – Coto 47
MRCH – Chacarita Airport – Chacarita
MRCR (RIK) – Carrillo Airport – Carrillo
MRCV – Cabo Velas Airport – Cabo Velas
MRDK (DRK) – Drake Bay Airport – Drake Bay
MRDO – Dieciocho Airport (military) – Dieciocho
MREC – El Carmen de Siquirres Airport – El Carmen de Siquirres
MRFI – Nuevo Palmar Sur Airport – Nuevo Palmar Sur
MRFL (FMG) – Flamingo Airport (Costa Rica) – Flamingo
MRFS – Finca 63 Airport – Finca 63
MRGF (GLF) – Golfito Airport – Golfito
MRGP (GPL) – Guápiles Airport – Guápiles
MRIA (PBP) – Punta Islita Airport – Punta Islita
MRLB (LIR) – Daniel Oduber International Airport – Liberia
MRLC (LSL) – Los Chiles Airport – Los Chiles
MRLE – Laurel Airport – Laurel
MRLF – La Flor Airport – La Flor
MRLM (LIO) – Limón International Airport – Limón
MRLP (LSP) – Las Piedras Airport – Las Piedras
MRLT – Las Trancas Airport – Las Trancas
MRNC (NCT) – Nicoya Guanacaste Airport – Nicoya Guanacaste
MRNS (NOM) – Nosara Airport – Nosara
MROC (SJO) – Juan Santamaría International Airport – San José
MRPA – Palo Arco Airport – Palo Arco
MRPD – Pandora Airport – Pandora
MRPJ (PJM) – Puerto Jimenez Airport – Puerto Jimenez
MRPM (PMZ) – Palmar Sur Airport – Palmar Sur
MRPV (SYQ) – Tobías Bolaños International Airport – San José
MRQP (XQP) – La Managua Airport – Quepos
MRRF (RFR) – Rio Frio O Progreso Airport – Rio Frio O Progreso
MRSA – San Alberto Airport – San Alberto
MRSG – Santa Clara de Guapiles Airport – Santa Clara de Guapiles
MRSL – Salama Airport – Salama
MRSO – Santa Maria de Guacimo Airport – Santa Maria de Guacimo
MRSV (TOO) – San Vito de Java Airport – San Vito de Java
MRTM (TNO) – Tamarindo Airport – Tamarindo
MRTR (TMU) – Tambor Airport – Tambor
MRUP (UPL) – Upala Airport – Upala


== MS - El Salvador ==
Also see airport category and list.

MSBS – Barrillas Airport – Barrillas
MSCB – La Cabana Airport – La Cabana
MSCD – Ceiba Doblada Airport – Ceiba Doblada
MSCH – La Chepona Airport – La Chepona
MSCM – Corral De Mulas Airport – Corral De Mulas
MSCN – Cumichin Airport – Cumichin
MSCR – La Carrera Airport – La Carrera
MSCS – Las Cachas Airport – Las Cachas
MSEJ – El Jocotillo Airport – El Jocotillo
MSER – Entre Rios Airport – Entre Rios
MSES – Espiritu Santo Airport – Espiritu Santo
MSET – El Tamarindo Airport – El Tamarindo
MSLD – Los Comandos Airport – Los Comandos (San Francisco Gotera)
MSLP (SAL) – El Salvador International Airport – San Salvador
MSPP – El Papalon Airport – El Papalon
MSPT – El Platanar Airport – El Platanar
MSRC – El Ronco Airport – El Ronco
MSSA – El Palmer Airport – Santa Ana
MSSC – Santa Clara Airport – Santa Clara
MSSJ – Punta San Juan Airport – Punta San Juan
MSSM – San Miguel Airport (El Papalon) – San Miguel
MSSS – Ilopango International Airport – San Salvador
MSZT – El Zapote Airport – El Zapote


== MT - Haiti ==
Also see airport category and list.

MTCA (CYA) – Les Cayes Airport – Les Cayes
MTCH (CAP) – Cap-Haitien International Airport – Cap-Haitien
MTJA (JAK) – Jacmel Airport – Jacmel
MTJE (JEE) – Jérémie Airport – Jérémie
MTPP (PAP) – Port-au-Prince International Airport (Toussaint Louverture Int'l) – Port-au-Prince
MTPX (PAX) – Port-de-Paix Airport – Port-de-Paix


== MU - Cuba ==
Also see airport category and list.

MUBA (BCA) – Gustavo Rizo Airport – Baracoa
MUBR – Las Brujas Airport – Las Brujas
MUBY (BYM) – Carlos Manuel de Cespedes Airport – Bayamo
MUCA (AVI) – Maximo Gomez International Airport – Ciego de Ávila
MUCB – Caibarien Airport – Caibarién
MUCC (CCC) – Jardines del Rey Airport – Cunagua, Cayo Coco
MUCF (CFG) – Jaime González Airport – Cienfuegos
MUCL (CYO) – Vilo Acuña Airport – Cayo Largo del Sur
MUCM (CMW) – Ignacio Agramonte International Airport – Camagüey
MUCU (SCU) – Antonio Maceo International Airport – Santiago
MUFL – Florida Airport – Florida
MUGM (NBW) – NAS Guantanamo Bay – Guantánamo Bay
MUGT (GAO) – Mariana Grajales Airport – Guantánamo
MUHA (HAV) – José Martí International Airport – Havana
MUHG (HOG) – Frank País Airport – Holguín
MUKW (VRO) – Kawama Airport – Kawama
MULB – Ciudad Libertad Airport – Havana
MULM (LCL) – La Coloma Airport – Pinar del Río
MUMG – Managua Airport – Managua
MUML – Mariel Airport – Mariel
MUMO (MOA) – Orestes Acosta Airport – Moa
MUMZ (MZO) – Sierra Maestra Airport – Manzanillo
MUNB (QSN) – San Nicolas de Bari Airport – San Nicolas de Bari
MUNC (ICR) – Nicaro Airport – Nicaro
MUNG (GER) – Rafael Cabrera Airport – Nueva Gerona
MUOC (CCC) – Cayo Coco Airport – Cayo Coco
MUPB – Playa Baracoa Airport – Havana
MUPR (QPD) – Pinar del Río Norte Airport – Pinar del Río Norte
MUSA – San Antonio de los Banos Airport – San Antonio de los Baños
MUSC (SNU) – Abel Santa María Airport – Santa Clara
MUSJ (SNJ) – San Julian Air Base – Pinar del Río
MUSL – Santa Lucia Airport – Playa Santa Lucia
MUSN (SZJ) – Siguanea Airport – Isla de la Juventud
MUSS – Sancti Spiritus Airport – Sancti Spíritus
MUTD (TND) – Alberto Delgado Airport – Trinidad
MUVR (VRA) – Juan Gualberto Gomez International Airport – Varadero
MUVT (VTU) – Hermanos Ameijeiras Airport – Las Tunas


== MW - Cayman Islands ==
Also see airport category and list.

MWCB (CYB) – Gerrard Smith International Airport – Cayman Brac
MWCG – Grand Cayman Airport – Grand Cayman
MWCL (LYB) – Edward Bodden Airfield (Little Cayman Airport) – Little Cayman
MWCR (GCM) – Owen Roberts International Airport – Georgetown, Grand Cayman


== MY - Bahamas ==
Also see airport category and list.

MYAB (MAY) – Clarence Bain Airport – Andros
MYAF (ASD) – Andros Town International Airport – Andros Town, Andros
MYAG – Gorda Cay Airport (private) – Gorda Cay, Abaco
MYAK (COX) – Congo Town Airport – Congo Town, Andros
MYAM (MHH) – Marsh Harbour Airport – Marsh Harbour, Abaco
MYAN (SAQ) – San Andros Airport – Andros
MYAO – Mores Island Airport – Mores Island, Abaco
MYAP (AXP) – Spring Point Airport – Spring Point, Acklins
MYAS – Sandy Point Airport – Sandy Point, Abaco
MYAT (TCB) – Treasure Cay Airport – Treasure Cay, Abaco
MYAW (WKR) – Walker Cay Airport – Walker Cay, Abaco
MYAX – Spanish Cay Airport – Spanish Cay, Abaco
MYBC (CCZ) – Chub Cay International Airport – Chub Cay, Berry Islands
MYBG (GHC) – Great Harbour Cay Airport – Great Harbour Cay, Berry Islands
MYBO – Ocean Cay Airport – Ocean Cay, Bimini
MYBS (BIM) – South Bimini Airport – South Bimini, Bimini
MYBW – Big Whale Cay Airport – Big Whale Cay, Berry Islands
MYBX – Lt. Whale Cay Airport – Lt. Whale Cay, Berry Islands
MYCA (ATC) – Arthur's Town Airport – Arthur's Town, Cat Island
MYCB (CAT) – New Bight Airport – New Bight, Cat Island
MYCC – Cat Cay Airport – Cat Cay, Bimini
MYCH – Hawks Nest Airport – Hawks Nest, Cat Island
MYCI (CRI) – Colonial Hill Airport – Colonial Hill, Crooked Island
MYCP – Pitts Town Airport – Pitts Town, Crooked Island
MYCS – Cay Sal Airport (private) – Cay Sal
MYCX – Cutlass Bay Airport – Cutlass Bay, Cat Island
MYEB – Black Point Airport – Black Point, Exuma
MYEC (CEL) – Cape Eleuthera Airport (closed) – Cape Eleuthera, Eleuthera
MYEF (GGT) – Exuma International Airport – Great Exuma Island, Exuma
MYEH (ELH) – North Eleuthera Airport – North Eleuthera, Eleuthera
MYEL – Lee Stocking Airport – Lee Stocking, Exuma
MYEM (GHB) – Governor's Harbour Airport – Governor's Harbour, Eleuthera
MYEN (NMC) – Norman's Cay Airport – Norman's Cay, Exuma
MYER (RSD) – Rock Sound International Airport – Rock Sound, Eleuthera
MYES (TYM) – Staniel Cay Airport – Staniel Cay, Exuma
MYEY – Hog Cay Airport – Hog Cay, Exuma
MYGF (FPO) – Grand Bahama International Airport (Freeport Int'l) – Freeport, Grand Bahama
MYGW – West End Airport (closed) – Grand Bahama
MYIG (IGA) – Inagua Airport (Matthew Town Airport) – Matthew Town, Inagua
MYLD (LGI) – Deadman's Cay Airport – Deadman's Cay, Long Island
MYLM – Cape Santa Maria Airport – Cape Santa Maria, Long Island
MYLR – Hard Bargain Airport – Long Island
MYLS (SML) – Stella Maris Airport – Long Island
MYMM (MYG) – Mayaguana Airport – Mayaguana
MYNN (NAS) – Lynden Pindling International Airport (Nassau Intl) – Nassau, New Providence
MYPI (PID) – New Providence Airport – Paradise Island, New Providence
MYRD (DCT) – Duncan Town Airport – Duncan Town, Ragged Island
MYRP – Port Nelson Airport – Port Nelson, Rum Cay
MYSM (ZSA) – San Salvador Airport (Cockburn Town Airport) – Cockburn Town, San Salvador Island


== MZ - Belize ==
Also see airport category and list.

MZBZ (BZE) – Philip S. W. Goldson International Airport – Belize City
MZ10 (SPR) San Pedro Airport


== References ==
"ICAO Location Indicators by State" (PDF). International Civil Aviation Organization. 2006-01-12. मूल से 26 सितंबर 2007 को पुरालेखित (PDF). अभिगमन तिथि 14 अप्रैल 2009."संयुक्त राष्ट्र Code for Trade and Transport Locations] [includes IATA codes". UN/LOCODE 2006-2. UNECE. 2007-04-30. मूल से 9 मई 2007 को पुरालेखित. अभिगमन तिथि 14 अप्रैल 2009.