revision: 60909088
title: "\u0642\u0627\u0626\u0645\u0629 \u0627\u0644\u0645\u0637\u0627\u0631\u0627\u062A\
  \ \u062D\u0633\u0628 \u0643\u0648\u062F \u0627\u0644\u0625\u064A\u0643\u0627\u0648\
  : K"
url: https://ar.wikipedia.org/wiki/%D9%82%D8%A7%D8%A6%D9%85%D8%A9_%D8%A7%D9%84%D9%85%D8%B7%D8%A7%D8%B1%D8%A7%D8%AA_%D8%AD%D8%B3%D8%A8_%D9%83%D9%88%D8%AF_%D8%A7%D9%84%D8%A5%D9%8A%D9%83%D8%A7%D9%88:_H


---

قائمة المطارات حسب رمز الإيكاو: A - B - C - D - E - F - G - H - I - J - K - L - M - N - O - P - Q - R - S - T - U - V - W - X - Y - Z
فيما يلي قائمة المطارات حسب رمز الإيكاو: H.تنسيق المدخلات هي:
كود منظمة الطيران المدني الدولي (إيكاو)(إياتا) - اسم المطار - موقع المطار


== HA - إثيوبيا ==
ADD) HAAB) - مطار أديس أبابا بولي الدولي - أديس أبابا
HAAL - مطار ليديتا للجيش - أديس أبابا
AXU) HAAX) - مطار أكسوم - أكسوم
BJR) HABD) - مطار بحر دار - بحر دار
BCY) HABU) - مطار بولشي - بولتشي
DSE) HADC) - مطار كومبولشا - ديسي
(DEM) - مطار ديمبيدولو - ديمبيدولو
DBM) HADM) - مطار ديبري ماركوس - دبري ماركوس
DBT) HADT) - مطار ديبري تابور - ديبري تابور
FNH) HAFN) - مطار فينشا - فينيشا
GOB) HAGB) - مطار روب - جوبا
GMB) HAGM) - مطار غامبيلا - غامبيلا
GDQ) HAGN) - مطار قوندر - قوندر
GDE) HAGO) - مطار جود (عسكري) - جود
GOR) HAGR) - مطار جور - جور
QHR) HAHM) - مطار هرار ميدا - دبري زيت
JIM) HAJM) - مطار أبا سيجود - جيما
LFO ) HAKL) - مطار كيلافو - كيلافو
AWA) HALA) - مطار أواسا - أواسا
MQX) HAMK) - مطار علا أبا نيجا - ميكيلي
NDM) HAMN) - مطار مندي - مندي
MTF) HAMT) - مطار ميزان تيفيري - ميزان تيفيري
NEJ) HANJ) - مطار نيجو - نيجو
NEK) HANK) - مطار نكيمتي - نكيمتي
TIE) HATP) - مطار تيبي - تيبي
WAC) HAWC) - مطار واكا - واكا


== HB - بوروندي ==
BJM) HBBA) - مطار بوجومبورا الدولي - بوجومبورا
HBBE (دائرة المخابرات العامة) - مطار غيتيغا - غيتيغا
KRE) HBBO) - مطار كيروندو - كيروندو


== HC - الصومال ==
ALU) HCMA) - مطار العلا - العلا
BIB) HCMB) - مطار بيدوا - بيدوا
CXN) HCMC)- مطار كاندالا - كاندالا
BSY)HCMD) - مطار بارديرا - بارديرا
HCM) HCME)- مطار إيلا -إيلا
BSA) HCMF) - مطار بوصاصو الدولي - بوصاصو
GSR) HCMG) - مطار قرضو - قرضو
HGA) HCMH) - مطار هرجيسا الدولي - هرجيسا
BBO) HCMI) - مطار بربرة - بربرة
KMU) HCMK ) - مطار كيسمايو - كيسمايو
MGQ) HCMM) - مطار آدم عبد الله الدولي - مقديشو
HCMN - مطار بلد وين - بلد وين
GLK) HCMR) - مطار عبد الله يوسف الدولي - غالكايو
BUO) HCMV) - مطار بوراو - بوراو
GGR) HCMW) - مطار جاروي الدولي - جاروي
BXX) HCMT) - مطار بوراما الدولي - بوراما


== HD - جيبوتي ==
JIB) HDAM)- مطار جيبوتي الدولي - مدينة جيبوتي
AII) HDAS)- مطار علي صبيح - علي صبيح
HDDK - مطار دخيل - دخيل
HDHE - مطار هيركال - هيركال
MHI) HDMO)- مطار موشا - جزيرة موشا
OBC) HDOB) - مطار أوبوك - أوبوك
TDJ) HDTJ) - مطار تجرة - تجرة


== HE - مصر ==
DBB) HEAL)- مطار العلمين الدولي - العلمين
AAC) HEAR) - مطار العريش الدولي - العريش
ATZ) HEAT) - مطار أسيوط الدولي - أسيوط
ALY) HEAX) - مطار النزهة - الإسكندرية
HBE) HEBA) - مطار برج العرب الدولي - الإسكندرية
ABS) HEBL) - مطار أبو سمبل - أبو سمبل
CAI) HECA) - مطار القاهرة الدولي - القاهرة
CCE) HECP) - مطار العاصمة الدولي - القاهرة الجديدة
CWE) HECW) - قاعدة غرب القاهرة الجوية - القاهرة
HRG) HEGN) - مطار الغردقة الدولي - الغردقة
HGO) HEGO) - مطار الجونة - الجونة
HEGR - مطار الجورة - الجورة
UVL) HEKG) - مطار الخارجة - الخارجة
LXR) HELX) - مطار الأقصر الدولي - الأقصر
RMF) HEMA) - مطار مرسى علم الدولي - مرسى علم
MUH) HEMM) - مطار مرسى مطروح الدولي - مرسى مطروح
HEOC - مطار 6 أكتوبر - مدينة السادس من أكتوبر
GSQ) HEOW) - مطار شرق العوينات - شرق العوينات
PSD) HEPS) - مطار بورسعيد - بورسعيد
SKV) HESC) - مطار سانت كاترين الدولي - سانت كاترين
HMB) HESG) - مطار سوهاج الدولي - سوهاج
SSH) HESH) - مطار شرم الشيخ الدولي - شرم الشيخ
ASW) HESN) - مطار أسوان الدولي - أسوان
SPX) HESX) - مطار سفنكس الدولي - الجيزة
TCP) HETB) - مطار طابا الدولي - طابا
ELT) HETR) - مطار الطور - الطور


== HH - إريتريا ==
ASM) HHAS) - مطار أسمرة الدولي - أسمرة
MSW) HHMS) - مطار مصوع الدولي - مصوع
ASA) HHSB) - مطار عصب الدولي - عصب


== HK - كينيا ==
ASV) HKAM) - مطار أمبوسيلي - أمبوسيلي
HKBA - مطار بوسيا - بوسيا
HKBR - مطار بورا إيست - بورا
HKBU -مطار بونغوما - بونغوما

HKDA - مهبط داداب - داداب

EDL) HKEL) - مطار إلدوريت الدولي - إلدوريت
HKEM - مطار امبو - امبو
EYS) HKES) - مطار إيلي سبرينجز - إيلي سبرينجز
HKEW - مطار الواك - الواك
KLK) HKFG)- مطار كالوكول - كالوكول

GAS) HKGA) - مطار غاريسا - غاريسا
HKGT - مطار غاربا تولا - غاربا تولا
HKHB - مطار خليج هوما - خليج هوما
HOA) HKHO) - مطار هولا - هولا
HKIK - مطار أورلي - أورلي
NBO) HKJK) - مطار جومو كينياتا الدولي (مطار نيروبي الدولي سابقًا) - نيروبي
HKKA - مطار كبارك - كبارك
KEU) HKKE) - مطار كيكوروك - ماساي مارا
KIS) HKKI) - مطار كيسومو - كيسومو
ILU) HKKL) - مطار كيلاجوني - كيلاجوني
KEY) HKKR) - مطار كيريشو - كيريشو

LOK) HKLO) - مطار ودوار - ودوار
LAU) HKLU) - مطار موانا - لامو
NDE) HKMA) - مطار مانديرا - مانديرا
RBT) HKMB) - مطار مارسابيت - مارسابيت
MYD) HKML) - مطار ماليندي - ماليندي
MBA) HKMO) - مطار مومباسا الدولي - مومباسا
OYL) HKMY) - مطار مويال السفلي - مويالي
NYE) HKNI) - مطار نيري - نيري
NUU) HKNK) - مطار ناكورو - ناكورو
NYK) HKNL)- مطار نانيوكي - نانيوكي
WIL) HKNW) - مطار ويلسون - نيروبي
HKNY - قاعدة لايكيبيا الجوية - نانيوكي
HKRE - مطار إيستلي - نيروبي
UAS) HKSB) - مطار سامبورو - سامبورو
WJR) HKWJ) - مطار واجير - واجير


== HL - ليبيا ==
GHT) HLGT) - مطار غات - غات
AKF) HLKF) - مطار الكفرة - الكفرة
BEN) HLLB) - مطار بنينا الدولي - بنغازي
MJI) HLLM) - مطار معيتيقة الدولي - طرابلس
LAQ) HLLQ) - مطار الأبرق الدولي - البيضاء
SEB) HLLS) - مطار سبها الدولي - سبها
TIP) HLLT) - مطار طرابلس الدولي - طرابلس
LMQ) HLMB) - مطار مرسى البريقة - مرسى البريقة
MRA) HLMS) - مطار مصراتة الدولي - مصراتة
LTD) HLTD) - مطار غدامس - غدامس


== HR - رواندا ==
GYI) HRYG) - مطار جيسيني - جيسيني
BTQ) HRYI) - مطار بوتاري - بوتاري
KLG) HRYR) - مطار كيغالي الدولي - كيغالي
RHG) HRYU) - مطار روهينغيري - روهينجيري
KME) HRZA) - مطار كاميمبي - سيانغوغو


== HS - السودان وجنوب السودان ==


=== السودان ===
ATB) HSAT) - مطار عطبرة - عطبرة
EDB) HSDB) - مطار الدبة - الدبة
DOG) HSDN) - مطار دنقلا - دنقلا
ELF) HSFS) - مطار الفاشر - الفاشر
DNX) HSGG) - مطار غاليغو - الدندر
EGN) HSGN) - مطار الجنينة - الجنينة
KSL) HSKA) - مطار كسلا - كسلا
GBU) HSKG) - مطار خشم القربة - خشم القربة
KST) HSKI) - مطار ربك - كوستي
MWE) HSMR) - مطار مروي - مروي
NUD) HSNH) - مطار النهود - النهود
UYL) HSNN) - مطار نيالا - نيالا
EBD) HSOB) - مطار الأبيض - الأبيض
PZU) HSPN) - مطار بورتسودان الدولي - بورتسودان
HSSP - مطار بورتسودان العسكري - بورتسودان
KRT) HSSS) - مطار الخرطوم الدولي - الخرطوم
WHF) HSSW) - مطار وادي حلفا - وادي حلفا


=== جنوب السودان ===
HSAK - مطار أكوبو - أكوبو
HSAW - مطار أويل - أويل
HSBR - مطار بور - بور
HSBT - مطار بانتيو - بانتيو
HSFA - مطار بالويتش - بالويتش
HSGO - مطار قوقريال - قوقريال
HSKJ - مطار كاجو  - كاجو
HSKP - مطار كبويتا - كبويتا
HSMD - مطار ماريدي - ماريدي
RBX) HSMK) - مطار رمبيك - رمبيك
HSNM -مطار نمولي - نمولي
HSPI - مطار بيبور - بيبور
HSRJ - مطار راجا - راجا
HSRN - مطار رنك  - الرنك
JUB) HSSJ) - مطار جوبا - جوبا
MAK) HSSM) - مطار ملكال - ملكال
HSTO - مطار تونج - تونج
HSTR - مطار توريت - توريت
HSTU - مطار تومبورا - تومبورا
WUU) HSWW )- مطار واو - واو
HSYA - مطار يامبيو - يامبيو
HSYE - مطار ياي - ياي
HSYL - مطار ييرول - ييرول


== HT - تنزانيا ==
ARK) HTAR) - مطار أروشا - أروشا
BKZ) HTBU) - مطار بوكوبا - بوكوبا
DAR) HTDA) - مطار دار السلام - دار السلام
DOD) HTDO) - مطار دودوما - دودوما
IRI) HTIR) - مطار إيرينجا - إيرينغا
TKQ) HTKA) - مطار كيغوما - كيغوما
KIY) HTKI) - مطار كيلوا ماسوكو - كيلوا ماسوكو
JRO) HTKJ) - مطار كليمنجارو الدولي - جبل كليمنجارو
LDI) HTLI) - مطار ليندي كيكويتو - ليندي
LKY) HTLM) - مطار بحيرة مانيارا - بحيرة مانيارا

MBI) HTMB)- مطار مبيا - مبيا

QSI) HTMS) - مطار موشي - موشي
MYW) HTMT)- مطار متوارا - متوارا
MUZ) HTMU) - مطار موسوما - موسوما
MWZ) HTMW) - مطار موانزا - موانزا
JOM) HTNJ) - مطار نجومبي - نجومبي
PMA) HTPE) - مطار بيمبا - بيمبا

SUT) HTSU) - مطار سومباوانغا - سومباوانغا
TBO) HTTB) - مطار تابورا - تابورا
TGT) HTTG) - مطار تينجا - تينجا
ZNZ) HTZA) - مطار عبيد أماني كرومي الدولي - زنجبار


== HU - أوغندا ==
HUAG - مطار أدجوماني - أدجوماني
RUA) HUAR )- مطار أروا - أروا
HUBU - مطار بونديبوغيو - بونديبوغيو
EBB) HUEN) - مطار إنتيبي الدولي - عنتيبي (بالقرب من كامبالا)
ULU) HUGU) - مطار جولو أوغندا - جولو
GEN) HUGE) - مطار جينجا - جينجا
HUKB - مطار كابالي - كابالي
HUKC - مطار كامبالا الدولي - كامبالا
KBG) HUKF) - مطار كاباليجا فولز (HUPA المعاد تصميمه) - باكوبا

HUKU- مطار كوتيدو - كوتيدو
KSE) HUKS)- مطار كاسيسي - كاسيسي
MBQ) HUMA)- مطار مبارارا - مبارارا
KCU) HUMI) - مطار ماسيندي - ماسيندي
TES) HHTS)- مطار هونك ناكاسونغولا - ناكاسونغولا
PAF) HUPA )- مطار باكوبا - باكوبا
SRT) HUSO) - مطار سوروتي - سوروتي
TRY) HUTO) - مطار تورورو - تورورو


== المراجع ==

بوابة طيران
بوابة إفريقيا
بوابة إثيوبيا
بوابة الصومال
بوابة جيبوتي
بوابة مصر
بوابة السودان
بوابة تنزانيا
بوابة كينيا
بوابة أوغندا
بوابة إريتريا
بوابة بوروندي
بوابة ليبيا
بوابة جنوب السودان
بوابة رواندا