revision: 60799985
title: Wyoming station (Ontario)
url: https://ar.wikipedia.org/wiki/%D9%82%D8%A7%D8%A6%D9%85%D8%A9_%D8%A7%D9%84%D9%85%D8%B7%D8%A7%D8%B1%D8%A7%D8%AA_%D8%AD%D8%B3%D8%A8_%D9%83%D9%88%D8%AF_%D8%A7%D9%84%D8%A5%D9%8A%D9%83%D8%A7%D9%88:_K


---

قائمة المطارات حسب كود الإيكاو: A - B - C - D - E - F - G - H - I - J - K - L - M - N - O - P - Q - R - S - T - U - V - W - X - Y - Z
نمط القائمة كالتالي:منظمة الطيران المدني الدولي، إياتا - اسم المطار - موقع المطار


== K – الولايات المتحدة ==


=== KA ===
KAAA – Logan County Airport – لينكولن
KAAF (AAF) – مطار أبالاتشيكولا الإقليمي – أبالاتشيكولا
KAAO – Colonel James Jabara Airport – ويتشيتا
KAAS – Taylor County Airport – كامبلسفيل
KAAT – Alturas Municipal Airport – ألتوراس
KABE (ABE) – Lehigh Valley International Airport – ألينتاون، بيت لحم وإيستون، بنسيلفانيا
KABI (ABI) – Abilene Regional Airport – أبيلين
KABQ (ABQ) – Albuquerque International Sunport – ألباكركي
KABR (ABR) – Aberdeen Regional Airport – أبردين
KABY (ABY) – Southwest Georgia Regional Airport – ألباني
KACB (ACB) – Antrim County Airport – بيلايري
KACJ – Jimmy Carter Regional Airport – أميريكوس
KACK (ACK) – Nantucket Memorial Airport – نانتوكيت
KACP – Allen Parish Airport – أوكدل
KACQ – Waseca Municipal Airport – واسيكا
KACT (ACT) – Waco Regional Airport – واكو
KACV (ACV) – Arcata-Eureka Airport – أركاتا
KACY (ACY) – Atlantic City International Airport – أتلانتيك سيتي
KACZ – Henderson Field – والاس
KADC – Wadena Municipal Airport – وادينا
KADF – Dexter B. Florence Memorial Field – أركدلفيا
KADG (ADG) – Lenawee County Airport – أدريان
KADH (ADT) – Ada Municipal Airport – أدا
KADM (ADM) – Ardmore Municipal Airport – أدمور
KADS (ADS) – Addison Airport – أديسون
KADT – Atwood–Rawlins County City–County Airport – أتوود
KADU – Audubon County Airport – أودوبون
KADW (ADW) – Andrews Air Force Base – كامب سبرينغز
KAEG – Double Eagle II Airport – ألباكركي
KAEJ – Central Colorado Regional Airport – بوينا فيستا
KAEL (AEL) – Albert Lea Municipal Airport – ألبرت ليا
KAEX (AEX) – Alexandria International Airport – الإسكندرية
KAFF (AFF) – مهبط أكاديمية سلاح الجو الأمريكي – كولورادو سبرينغز
KAFJ (WSG) – Washington County Airport – واشنطن
KAFK – Nebraska City Municipal Airport – نبراسكا سيتي
KAFN (AFN) – Jaffrey Airport – Silver Ranch Airpark – جافري
KAFO (AFO) – Afton Municipal Airport – أفتون
KAFP – Anson County Airport – ويدسبورو
KAFW (AFW) – Fort Worth Alliance Airport – فورت وورث
KAGC (AGC) – Allegheny County Airport – West Mifflin، Pennsylvania
KAGO (AGO) – Magnolia Municipal Airport – ماغنوليا
KAGR – MacDill AFB Auxiliary Field – أفون بارك
KAGS (AGS) – Augusta Regional Airport at Bush Field – أوغستا
KAGZ – Wagner Municipal Airport – واغنر
KAHC (AHC) – Amedee Army Airfield – Herlong، California
KAHH (AHH) – Amery Municipal Airport – أميري
KAHN (AHN) – Athens Ben Epps Airport – أثينا
KAHQ – Wahoo Municipal Airport – واهو
KAIA (AIA) – Alliance Municipal Airport – أليانس
KAIB – Hopkins-Montrose County Airport – نوكلا
KAID (AID) – Anderson Municipal Airport – أندرسون
KAIG – Langlade County Airport – أنتيغو
KAIK (AIK) – Aiken Regional Airport – أيكن
KAIO (AIO) – Atlantic Municipal Airport – أتلانتيك
KAIT – Aitkin Municipal Airport – أيتكن
KAIV (AIV) – George Downer Airport – أليسفيل
KAIY (AIY) – Atlantic City Municipal Airport – أتلانتيك سيتي (أغلق في 2006)
KAIZ (AIZ) – Lee C. Fine Memorial Airport – ليك اوزارك
KAJG – Mount Carmel Municipal Airport – ماونت كرمل
KAJO – Corona Municipal Airport – كورونا
KAJR – Habersham County Airport – كورنيليا
KAJZ – Blake Field – دلتا
KAKH – Gastonia Municipal Airport – غاستونيا
KAKO (AKO) – Colorado Plains Regional Airport – أكرون
KAKQ – Wakefield Municipal Airport – ويكفيلد
KAKR (AKC) – Akron Fulton Executive Airport – آكرون
KALB (ALB) – Albany International Airport – ألباني
KALI (ALI) – Alice International Airport – أليس
KALK - Airstrip west of Libby AAF See KFHU
KALM (ALM) – Alamogordo–White Sands Regional Airport – ألاموغوردو
KALN (ALN) – St. Louis Regional Airport – ألتون
KALO (ALO) – Waterloo Regional Airport – واترلو
KALS (ALS) – San Luis Valley Regional Airport – ألاموسا
KALW (ALW) – Walla Walla Regional Airport – والا والا
KALX (ALX) – Thomas C. Russell Field – ألكسندر سيتي
KAMA (AMA) – Rick Husband Amarillo International Airport – أماريلو
KAMG – Bacon County Airport – ألما
KAMN (AMN) – Gratiot Community Airport – ألما
KAMT – Alexander Salamon Airport – وست يونيون
KAMW (AMW) – Ames Municipal Airport – أيمز
KANB (ANB) – Anniston Regional Airport – أننيستون
KAND (AND) – Anderson Regional Airport – أندرسون
KANE – Anoka County–Blaine Airport – مينيابوليس
KANJ – Sault Ste. Marie Municipal Airport – سولت سانت ماري
KANK – Harriet Alexander Field – ساليدا
KANP (ANP) – Lee Airport – أنابولس
KANQ (ANQ) – Tri-State Steuben County Airport – أنغولا
KANW (ANW) – Ainsworth Regional Airport – أينسورث
KANY (ANY) – Anthony Municipal Airport – أنتوني
KAOC – Arco Butte County Airport – أركو
KAOH (AOH) – Lima Allen County Airport – ليما
KAOO (AOO) – Altoona–Blair County Airport – ألتونا
KAOV – Ava Bill Martin Memorial Airport – آفا
KAPA (APA) – Centennial Airport – سينتينيال
KAPC (APC) – Napa County Airport – نابا
KAPF (APF) – مطار نيبلز – نيبلز
KAPG (APG) – Phillips Army Airfield – أرض الاختبار بمدينة أبردين، ماريلند
KAPH (APH) – A.P. Hill Army Airfield – Fort A.P. Hill، فرجينيا
KAPN (APN) – Alpena County Regional Airport – ألبينا
KAPT (APT) – Marion County Airport – جاسبر
KAPV (APV) – Apple Valley Airport – أببل فالي
KAQO – Llano Municipal Airport – لانو
KAQP – Appleton Municipal Airport – أبليتون
KAQR – Atoka Municipal Airport – أتوكا
KAQW – Harriman-and-West Airport – نورث آدمز
KARA (ARA) – Acadiana Regional Airport – نيو أيبيريا
KARB (ARB) – Ann Arbor Municipal Airport – آن آربر
KARG (ARG) – Walnut Ridge Regional Airport – والنوت ريدج
KARM (WHT) – Wharton Regional Airport – وارتون
KARR (AUZ) – Aurora Municipal Airport – أورورا
KART (ART) – Watertown International Airport – واتيرتاون
KARV (ARV) – Lakeland Airport – مينوكوا / وودروف
KARW (BFT) – Beaufort County Airport  – مقاطعة بوفورت، كارولاينا الجنوبية
KASD – Slidell Airport – سليدل
KASE (ASE) – Aspen–Pitkin County Airport – أسبن
KASG (SPZ) – Springdale Municipal Airport – سبرينغدل
KASH (ASH) – Nashua Airport – ناشوا
KASJ – Tri-County Airport – أهوسكي
KASL (ASL) – Harrison County Airport – مارشال
KASN (ASN) – Talladega Municipal Airport – تالاديغا
KAST (AST) – Astoria Regional Airport – أستوريا
KASW – Warsaw Municipal Airport – وارسو
KASX (ASX) – John F. Kennedy Memorial Airport – آشلاند
KASY (ASY) – Ashley Municipal Airport – أشلي
KATA – Hall–Miller Municipal Airport – أتلانتا
KATL (ATL) – مطار هارتسفيلد جاكسون – أتلانتا
KATS (ATS) – Artesia Municipal Airport – أرتيشيا
KATW (ATW) – Appleton International Airport – غرينفيل
KATY (ATY) – Watertown Regional Airport – ووترتاون
KAUG (AUG) – Augusta State Airport – أوغوستا
KAUH – Aurora Municipal Airport – أورورا
KAUM (AUM) – Austin Municipal Airport – أوستين
KAUN (AUN) – Auburn Municipal Airport – أوبورن
KAUO (AUO) – Auburn University Regional Airport – أوبورن
KAUS (AUS) – مطار أوستن برغستروم الدولي – أوستن
KAUW (AUW) – Wausau Downtown Airport – واوسو
KAVC – Mecklenburg-Brunswick Regional Airport – ساوث هيل
KAVK – Alva Regional Airport – ألفا
KAVL (AVL) – Asheville Regional Airport – فليتشر
KAVO (AVO) – Avon Park Executive Airport – أفون بارك
KAVP (AVP) – Wilkes-Barre/Scranton International Airport – أفوكا
KAVQ (AVW) – Marana Regional Airport – مارانا
KAVX (CIB) – Catalina Airport – أفالون / جزيرة سانتا كاتالينا
KAWG – Washington Municipal Airport – واشنطن
KAWM (AWM) – West Memphis Municipal Airport – ويست ممفيس
KAWO – Arlington Municipal Airport – أرلينغتون
KAXA (AXG) – Algona Municipal Airport – ألجونا
KAXH – Houston Southwest Airport – أركولا
KAXN (AXN) – Alexandria Municipal Airport – ألكساندريا
KAXQ – Clarion County Airport – Clarion، Pennsylvania
KAXS (AXS) – Altus/Quartz Mountain Regional Airport – ألتوس
KAXV (AXV) – Neil Armstrong Airport – واباكونيتا
KAXX (AXX) – Angel Fire Airport – أنجل فاير
KAYS (AYS) – Waycross–Ware County Airport – وايكروس
KAYX – Arnold Air Force Base – تولاهوما
KAZC – Colorado City Municipal Airport – كولورادو سيتي
KAZE – Hazlehurst Airport – هازلهورست
KAZO (AZO) – Kalamazoo/Battle Creek International Airport – كالامازو / باتل كريك
KAZU – Arrowhead Assault Strip – Fort Chaffee، Arkansas


=== KB ===
KBAB (BAB) – Beale Air Force Base – ماريسفيل
KBAC - Barnes County Municipal Airport - فالي سيتي
KBAD (BAD) – Barksdale Air Force Base – بوسير سيتي
KBAF (BAF) – Westfield-Barnes Regional Airport – ويستفيلد / سبرينغفيلد
KBAK (CLU) – Columbus Municipal Airport – كولومبوس
KBAM (BAM) – Battle Mountain Airport – باتل ماونتن
KBAN - Bryant Field - Bridgeport، California
KBAX – Huron County Memorial Airport – باد إكس
KBAZ – New Braunfels Regional Airport – نيو براونفيلز
KBBB (BBB) – Benson Municipal Airport – بنسون
KBBD – Curtis Field – برادي
KBBG (BKG) – Branson Airport  – برانسون
KBBP (BTN) – Marlboro County Jetport – بينتسفيل
KBBW (BBW) – Broken Bow Municipal Airport – بروكن باو
KBCB (BCB) – VirginiaTech/Montgomery Executive Airport – بلاكسبرغ
KBCE (BCE) – Bryce Canyon Airport – برايس كانيون
KBCK – Black River Falls Area Airport – بلاك ريفر فولز
KBCT (BCT) – Boca Raton Airport – بوكا راتون
KBDE (BDE) – Baudette International Airport – باوديت
KBDG (BDG) – Blanding Municipal Airport – بلاندينغ
KBDH (ILL) – Willmar Municipal Airport – ويلمر
KBDJ – Boulder Junction Airport – بولدير
KBDL (BDL) – Bradley International Airport – Windsor Locks / هارتفورد
KBDN - Bend Municipal Airport - بيند
KBDQ – Morrilton Municipal Airport – موريلتون
KBDR (BDR) – Igor I. Sikorsky Memorial Airport – بريدجبورت
KBDU – Boulder Municipal Airport – بولدر
KBEC (BEC) – Beech Factory Airport – ويتشيتا
KBED (BED) – Laurence G. Hanscom Field – Bedford، Massachusetts
KBEH (BEH) – Southwest Michigan Regional Airport – بينتون هاربور
KBFA – Boyne Mountain Airport – بيوني فالس
KBFD (BFD) – Bradford Regional Airport – برادفورد
KBFE – Terry County Airport – براونفيلد
KBFF (BFF) – Western Nebraska Regional Airport – سكوتسبلوف
KBFI (BFI) – بوينغ فيلد – سياتل
KBFK – Buffalo Municipal Airport – بوفالو
KBFL (BFL) – Meadows Field Airport – بيكرسفيلد
KBFM (BFM) – Mobile Downtown Airport – موبيل
KBFR (BFR) – Virgil I. Grissom Municipal Airport – بيدفورد
KBFW – Silver Bay Municipal Airport – سيلفر باي
KBGD – Hutchinson County Airport – بورجير
KBGE (BGE) – Decatur County Industrial Air Park – بينبردج
KBGF – Winchester Municipal Airport – وينشستر
KBGM (BGM) – Greater Binghamton Airport – بينغامتون
KBGR (BGR) – Bangor International Airport – بانجور
KBHB (BHB) – Hancock County-Bar Harbor Airport – بار هربور
KBHC – Baxley Municipal Airport – باكسلي
KBHK – Baker Municipal Airport – بيكر
KBHM (BHM) – Birmingham-Shuttlesworth International Airport – برمنغهام
KBID (BID) – Block Island State Airport – بلوك آيلاند
KBIE – Beatrice Municipal Airport – بياتريس
KBIF (BIF) – Biggs Army Airfield – Fort Bliss، إل باسو
KBIH (BIH) – Eastern Sierra Regional Airport – بيشوب
KBIL (BIL) – Billings Logan International Airport – بيلينغز
KBIS (BIS) – Bismarck Municipal Airport – بيسمارك
KBIV (BIV) – West Michigan Regional Airport – هولاند
KBIX (BIX) – قاعدة كيسلر الجوية – بيلوكسي
KBJC (BJC) – Rocky Mountain Metropolitan Airport – دنفر
KBJI (BJI) – Bemidji Regional Airport – بيمدجي
KBJJ (BJJ) – Wayne County Airport – ووستير
KBJN - Tonopah Test Range Airport - تونوباه
KBKD – Stephens County Airport – بريكنريدج
KBKE (BKE) – Baker City Municipal Airport – بيكر سيتي
KBKF – Buckley Space Force Base – أورورا
KBKL (BKL) – Cleveland Burke Lakefront Airport – كليفلاند
KBKN - Blackwell-Tonkawa Municipal Airport - بلاكويل
KBKS – Brooks County Airport – فالفورياس
KBKT (BKT) – Allen C. Perkinson Airport / Blackstone Army Airfield – بلاكستون
KBKV – Brooksville-Tampa Bay Regional Airport – بروكسفيل
KBKW (BKW) – Raleigh County Memorial Airport – بيكلي
KBKX (BKX) – Brookings Municipal Airport – بروكينغز
KBLF (BLF) – Mercer County Airport – بلوفيلد
KBLH (BLH) – Blythe Airport – بلايث
KBLI (BLI) – Bellingham International Airport – بيلينغام
KBLM (BLM) – Monmouth Executive Airport – بلمار / فارمينغدال
KBLU – Blue Canyon-Nyack Airport – Emigrant Gap، California
KBLV (BLV) – MidAmerica St. Louis Airport / Scott Air Force Base – بلفيل
KBMC (BMC) – Brigham City Airport – بريغهام سيتي
KBMG (BMG) – Monroe County Airport – بلومنغتون
KBMI (BMI) – Central Illinois Regional Airport – بلومنجتون
KBML (BML) – Berlin Regional Airport – برلين
KBMQ – Burnet Municipal Airport – بيرنت
KBMT (BMT) – Beaumont Municipal Airport – بومونت
KBNA (BNA) – مطار ناشفيل الدولي – ناشفيل
KBNG (BNG) – Banning Municipal Airport – بانينغ
KBNL – Barnwell Regional Airport – بارنويل
KBNO (BNO) – Burns Municipal Airport – بورنز
KBNW – Boone Municipal Airport – بون
KBOI (BOI) – Boise Air Terminal – بويسي
KBOK – Brookings Airport – بروكينغز
KBOS (BOS) – مطار لوجان الدولي – بوسطن
KBOW (BOW) – Bartow Executive Airport – بارتو
KBPG – Big Spring McMahon-Wrinkle Airport – بيغ سبرينغ
KBPI (BPI) – Miley Memorial Field – بيغ بيني
KBPK (WMH) – Ozark Regional Airport – ماونتن هوم
KBPP (BWM) – Bowman Municipal Airport – بومان
KBPT (BPT) – Jack Brooks Regional Airport – نيدرلاند
KBQK (BQK) – Brunswick Golden Isles Airport – برونزويك
KBQR (BQR) – Buffalo-Lancaster Regional Airport – لانكاستر
KBRD (BRD) – Brainerd Lakes Regional Airport – برينرد
KBRL (BRL) – Southeast Iowa Regional Airport – برلنغتون
KBRO (BRO) – Brownsville/South Padre Island International Airport – براونزفيل
KBRY – Samuels Field – باردستاون
KBST – Belfast Municipal Airport – بلفاست
KBTA - Blair Municipal Airport - بلير
KBTF (BTF) – Skypark Airport – بونتيفول
KBTL (BTL) – W. K. Kellogg Airport – باتل كريك
KBTM (BTM) – Bert Mooney Airport – بوتي
KBTN – Britton Municipal Airport – برايتون
KBTP (BTP) – Pittsburgh-Butler Regional Airport – بتلر
KBTR (BTR) – Baton Rouge Metropolitan Airport – باتون روج
KBTV (BTV) – Burlington International Airport – برلينغتون
KBTY (BTY) – Beatty Airport – بيتي
KBUB – Cram Field – بورويل
KBUF (BUF) – Buffalo Niagara International Airport – بوفالو
KBUM – بوتلر (ميزوري) – بوتلر
KBUR (BUR) – Hollywood Burbank Airport  – بربانك
KBUU – Burlington Municipal Airport – برلنغتون
KBUY – Burlington-Alamance Regional Airport – برلنغتون
KBVI (BFP) – Beaver County Airport – بيفير فولز
KBVN – Albion Municipal Airport – ألبيون
KBVO (BVO) – Bartlesville Municipal Airport – برتلسفيل
KBVS (MVW) – Skagit Regional Airport – بورلينجتون ومونت فيرنون
KBVU - Boulder City Municipal Airport - بولدر سيتي
KBVX (BVX) – Batesville Regional Airport – بيتسفيل
KBVY (BVY) – Beverly Regional Airport – بيفرلي
KBWC (BWC) – Brawley Municipal Airport – براولي
KBWD (BWD) – Brownwood Regional Airport – براونوود
KBWG (BWG) – Bowling Green-Warren County Regional Airport – بولينغ غرين
KBWI (BWI) – مطار بالتيمور واشنطن الدولي – بالتيمور وواشنطن العاصمة
KBWP – Harry Stern Airport – واهبتون
KBXA (BXA) – George R. Carr Memorial Airfield – بوغالوسا
KBXG – واينيسبورو (جورجيا) – واينيسبورو
KBXK (BXK) – Buckeye Municipal Airport – باكيي
KBXM (BXM) – Brunswick Executive Airport (formerly NAS Brunswick) – برونزويك
KBYG (BYG) – Johnson County Airport – بوفالو
KBYH (BYH) – Arkansas International Airport – بليثفيل
KBYI (BYI) – Burley Municipal Airport – بورلي
KBYS – Bicycle Lake Army Airfield – بارستاو
KBYY (BBC) – Bay City Municipal Airport – باي سيتي
KBZN (BZN) – Bozeman Yellowstone International Airport  – بوزيمان


=== KC ===
KCAD (CAD) – Wexford County Airport – كاديلاك
KCAE (CAE) – Columbia Metropolitan Airport – ويست كولومبيا (قريب من كولومبيا)
KCAG (CIG) – Craig-Moffat Airport – كريغ
KCAK (CAK) – Akron-Canton Regional Airport – آكرون (قريب من كانتون)
KCAO (CAO) – Clayton Municipal Airpark – كلايتون
KCAR (CAR) – Caribou Municipal Airport – كاريبو
KCAV – Clarion Municipal Airport – كلاريون
KCBE (CBE) – Greater Cumberland Regional Airport – كمبرلاند
KCBF (CBF) – Council Bluffs Municipal Airport – كونسيل بلوفس
KCBG – Cambridge Municipal Airport – كامبريدج
KCBK (CBK) – Colby Municipal Airport  – كولبي
KCBM (CBM) – Columbus Air Force Base – كولومبوس
KCCA – Clinton Municipal Airport – كلينتون
KCCB (CCB) – Cable Airport – آبلاند
KCCO – Newnan-Coweta County Airport – نيونان
KCCR (CCR) – Buchanan Field Airport – كونكورد
KCCY (CCY) – Northeast Iowa Regional Airport – تشارلز سيتي
KCDA (LLX) – Caledonia County Airport – ليندونفيل
KCDC (CDC) – Cedar City Regional Airport – سيدار سيتي
KCDD – Scotts Seaplane Base – Crane Lake، Minnesota
KCDH – Harrell Field  – كامدن
KCDI – Cambridge Municipal Airport – كامبردج
KCDK (CDK) – George T. Lewis Airport – سيدر كي
KCDN (CDN) – Woodward Field – كامدن
KCDR (CDR) – Chadron Municipal Airport – تشادرون
KCDS (CDS) – Childress Municipal Airport – تشايلدريس
KCDW (CDW) – Essex County Airport – Caldwell، New Jersey
KCEA (CEA) – Cessna Aircraft Field – ويتشيتا
KCEC (CEC) – Del Norte County Airport  – كريسينت سيتي
KCEF (CEF) – Westover Metropolitan Airport / Westover Air Reserve Base – سبرينغفيلد / شيكوبي
KCEK – Crete Municipal Airport – كريت
KCEU (CEU) – Oconee County Regional Airport – كليمسون
KCEV (CEV) – Mettel Field – كونرسفيل
KCEW (CEW) – Bob Sikes Airport – كريستفيو
KCEY (CEY) – Murray-Calloway County Airport – موراي
KCEZ (CEZ) – Cortez Municipal Airport – كورتيز
KCFD (CFD) – Coulter Field – بريان
KCFE – Buffalo Municipal Airport – بافلو
KCFJ – Crawfordsville Municipal Airport – كروفوردسفيل
KCFS – Tuscola Area Airport – كارو (ميشيغان)
KCFT (CFT) – Greenlee County Airport – كليفتون / مورنسي
KCFV (CFV) – Coffeyville Municipal Airport – كوفيفيل
KCGC – Crystal River Airport – كريستال ريفر
KCGE (CGE) – Cambridge-Dorchester Regional Airport – كامبريدج
KCGF (CGF) – Cuyahoga County Airport – كليفلاند
KCGI (CGI) – Cape Girardeau Regional Airport – كاب جيراردو
KCGS (CGS) – College Park Airport – كوليج بارك
KCGX - Meigs Field - شيكاغو، إلينوي (مغلق في 2003)
KCGZ (CGZ) – Casa Grande Municipal Airport – كازا غراندي
KCHA (CHA) – Chattanooga Metropolitan Airport – تشاتانوغا
KCHD – Chandler Municipal Airport – تشاندلر
KCHK (CHK) – Chickasha Municipal Airport – تشيكاشا
KCHN – Wauchula Municipal Airport – واوتشولا
KCHO (CHO) – Charlottesville-Albemarle Airport – شارلوتسفيل
KCHQ – Mississippi County Airport – تشارلزتون
KCHS (CHS) – Charleston International Airport (Charleston Air Force Base) – تشارلستون
KCHT – Chillicothe Municipal Airport – تشيليكوث
KCHU – Houston County Airport – كاليدونيا
KCIC (CIC) – Chico Municipal Airport – تشيكو
KCID (CID) – The Eastern Iowa Airport – سيدار رابيدز
KCII – Choteau Airport – تشوتيا
KCIN (CIN) – Arthur N. Neu Airport – كارول
KCIR – Cairo Regional Airport – القاهرة
KCIU (CIU) – Chippewa County International Airport – سولت سانت ماري
KCJJ – كريسكو – كريسكو
KCJR – Culpeper Regional Airport – كولبيبر
KCKA (CKA) – Kegelman Air Force Auxiliary Field – شيروكي
KCKB (CKB) – North Central West Virginia Airport – كلاركسبورغ
KCKC (GRM) – Grand Marais/Cook County Airport – غراند ماريس
KCKF (CKF) – Crisp County-Cordele Airport – كورديل
KCKI – Williamsburg Regional Airport – كينغستري
KCKM – Fletcher Field – كلاركسديل
KCKN (CKN) – Crookston Municipal Airport – كروكستون
KCKP – شيروكي (آيوا) – شيروكي
KCKV (CKV) – Clarksville-Montgomery County Regional Airport – كلاركسفيل
KCLE (CLE) – Cleveland Hopkins International Airport – كليفلاند
KCLI (CLI) – Clintonville Municipal Airport – كلينتونفيل
KCLK – Clinton Regional Airport – كلينتون
KCLL (CLL) – مطار إستر وود – كوليج ستيشن
KCLM (CLM) – William R. Fairchild International Airport – بورت أنجلوس
KCLR (CLR) – Cliff Hatfield Memorial Airport – كاليباتريا
KCLS (CLS) – Chehalis-Centralia Airport – شيهاليس
KCLT (CLT) – مطار شارلوت دوغلاس الدولي – شارلوت
KCLW (CLW) – Clearwater Air Park – كليرواتر
KCMA – Camarillo Airport – كاماريلو
KCMH (CMH) – John Glenn Columbus International Airport – كولومبوس
KCMI (CMI) – University of Illinois Willard Airport – سافوي
KCMR – H.A. Clark Memorial Field – ويليامز
KCMX (CMX) – Houghton County Memorial Airport – هانكوك
KCMY (CMY) – Sparta/Fort McCoy Airport – سبارتا
KCNC – Chariton Municipal Airport – تشارشن
KCNH (CNH) – Claremont Municipal Airport – كليرمونت
KCNI – Cherokee County Regional Airport – كانتون
KCNK (CNK) – Blosser Municipal Airport – كونكورديا
KCNM (CNM) – Cavern City Air Terminal – كارلسباد
KCNO (CNO) – Chino Airport – تشينو
KCNP – Billy G. Ray Field – تشابيل
KCNU (CNU) – Chanute Martin Johnson Airport – تشانوت
KCNW (CNW) – TSTC Waco Airport – واكو
KCNY (CNY) – Canyonlands Regional Airport – مواب
KCOD (COD) – Yellowstone Regional Airport – كودي
KCOE (COE) – Coeur d'Alene Air Terminal – كويور دي أليني
KCOF (COF) – Patrick Space Force Base – كوكاو بيتش
KCOI (COI) – Merritt Island Airport – ميريت آيلاند
KCOM – Coleman Municipal Airport – كولمان
KCON (CON) – Concord Municipal Airport – كونكورد
KCOQ – Cloquet Carlton County Airport – كلوكيه
KCOS (COS) – Colorado Springs Airport – كولورادو سبرينغز
KCOT (COT) – Cotulla-La Salle County Airport – كوتولا
KCOU (COU) – Columbia Regional Airport – كولومبيا
KCPC – Columbus County Municipal Airport – وايتفيل
KCPF – Wendell H. Ford Airport – هازارد
KCPK – Chesapeake Regional Airport – نورفولك
KCPM (CPM) – Compton/Woodley Airport – كومبتون
KCPR (CPR) – Natrona County International Airport – كاسبر
KCPS (CPS) – St. Louis Downtown Airport – كاهوكيا
KCPT – Cleburne Regional Airport – كيلبورن
KCPU (CPU) – Calaveras County Airport – سان أندرياس
KCQA – Lakefield Airport – سيلينا
KCQB – Chandler Regional Airport – تشاندلر
KCQC - Moriarty Municipal Airport - موريارتي
KCQF – H. L. Sonny Callahan Airport – فيرهوب
KCQM – Cook Municipal Airport – كوك
KCQW (HCW) – Cheraw Municipal Airport – تشيراو
KCQX – Chatham Municipal Airport – تشاتهام
KCRE (CRE) – Grand Strand Airport – نورث ميرتل بيتش
KCRG (CRG) – Jacksonville Executive at Craig Airport – جاكسونفيل
KCRO (CRO) – Corcoran Airport – كوركوران
KCRP (CRP) – Corpus Christi International Airport – كوربوس كريستي
KCRQ (CLD) – McClellan-Palomar Airport – كارلسباد
KCRS – Corsicana Municipal Airport – كورسيكانا
KCRT (CRT) – Z.M. Jack Stell Field – كروسيت
KCRW (CRW) – Yeager Airport – تشارلستون
KCRX (CRX) – Roscoe Turner Airport – كورينث
KCRZ – Corning Municipal Airport – كورنينج
KCSB – Cambridge Municipal Airport – كامبردج
KCSG (CSG) – Columbus Airport – كولومبوس
KCSM (CSM) – Clinton-Sherman Industrial Airpark – كلينتون
KCSQ (CSQ) – Creston Municipal Airport – كريستون
KCSV (CSV) – Crossville Memorial Airport – كروسفيل
KCTB (CTB) – Cut Bank Municipal Airport – كت بانك
KCTJ – West Georgia Regional Airport – كارولتون
KCTK – Ingersoll Airport – كانتون
KCTY (CTY) – Cross City Airport – كروس سيتي
KCTZ (CTZ) – Clinton-Sampson County Airport – كلينتون
KCUB (CUB) – Columbia Owens Downtown Airport – كولومبيا
KCUH – Cushing Municipal Airport – كوشينغ
KCUL – Carmi Municipal Airport – كرمي
KCUT – Custer County Airport – كستر
KCVG (CVG) – Cincinnati/Northern Kentucky International Airport – Hebron، Kentucky (قريب من سينسيناتي وكوفينغتون)
KCVH (HLI) – Hollister Municipal Airport – هوليستير
KCVK – Sharp County Regional Airport – أش فلات
KCVN (CVN) – Clovis Municipal Airport – كلوفيس
KCVO (CVO) – Corvallis Municipal Airport – كورفاليس
KCVS (CVS) – Cannon Air Force Base – كلوفيس
KCVX – Charlevoix Municipal Airport – شارليفوي
KCWA (CWA) – Central Wisconsin Airport – موسيني
KCWC - Kickapoo Downtown Airpark - ويتشيتا فولز
KCWF (CWF) – Chennault International Airport – ليك تشارلز
KCWI – Clinton Municipal Airport – كلينتون
KCWS – Dennis F. Cantrell Field – كونوي (مغلق، انظر: KCXW)
KCWV – Claxton-Evans County Airport – كلاكستون
KCXE – Chase City Municipal Airport – تشاس سيتي
KCXL (CXL) – Calexico International Airport – كاليكسيكو
KCXO (CXO) – Lone Star Executive Airport – هيوستن
KCXP (CXP) – Carson City Airport – كارسون سيتي
KCXU – Camilla-Mitchell County Airport – كاميلا
KCXW – Conway Municipal Airport – كونوي
KCXY (HAR) – Capital City Airport – هاريسبرج
KCYO – Pickaway County Memorial Airport – سيركلفيل
KCYS (CYS) – Cheyenne Regional Airport – شايان
KCYW – Clay Center Municipal Airport – كلاي سنتر
KCZD – Cozad Municipal Airport – كوزاد
KCZG (CZG) – Tri-Cities Airport – إنديكوت
KCZK (CZK) – Cascade Locks State Airport – كاسكاد لوكس
KCZL – Tom B. David Field – كالهون
KCZT – Dimmit County Airport – كاريزو سبرينغز


=== KD ===
KDAA (DAA) – Davison Army Airfield – Fort Belvoir، Virginia
KDAB (DAB) – مطار دايتونا بيتش الدولي – دايتونا بيتش
KDAF – Necedah Airport – نيسيده
KDAG – Barstow-Daggett Airport – Daggett، California
KDAL (DAL) – Dallas Love Field – دالاس
KDAN (DAN) – Danville Regional Airport – دانفيل
KDAW – Skyhaven Airport – روتشستر
KDAY (DAY) – James M. Cox International Airport – دايتون
KDBN – W. H. 'Bud' Barron Airport – دبلن
KDBQ (DBQ) – Dubuque Regional Airport – دوبوك
KDCA (DCA) – مطار رونالد ريغان الوطني – مقاطعة أرلنغتون
KDCU – Pryor Field Regional Airport – ديكاتور
KDCY – Daviess County Airport – واشنطن
KDDC (DDC) – Dodge City Regional Airport – دودج سيتي
KDDH – William H. Morse State Airport – بينينغتون
KDEC (DEC) – Decatur Airport – ديكادور
KDED – DeLand Municipal Airport – ديلاند
KDEH – Decorah Municipal Airport – ديكوراه
KDEN (DEN) – مطار دنفر الدولي (استبدال بمطار ستابلتون الدولي) – دنفر
KDEQ (DEQ) – J. Lynn Helms Sevier County Airport – دي كوين
KDET (DET) – Coleman A. Young International Airport – ديترويت
KDEW – Deer Park Airport – دير بارك
KDFI – Defiance Memorial Airport – ديفايانس
KDFW (DFW) – مطار دالاس فورت ورث الدولي – دالاس / فورت وورث
KDGL (DGL) – Douglas Municipal Airport – دوغلاس
KDGW (DGW) – Converse County Airport – دوغلاس
KDHN (DHN) – مطار دوثان الإقليمي – دوثان
KDHT – Dalhart Municipal Airport – دالهارت
KDIJ - Driggs-Reed Memorial Airport - دريغس
KDIK (DIK) – Dickinson – Theodore Roosevelt Regional Airport – ديكينسون
KDKB – DeKalb Taylor Municipal Airport – ديكالب
KDKK – Chautauqua County/Dunkirk Airport – دونكيرك
KDKR (DKR) – Houston County Airport – كروكيت
KDKX – Knoxville Downtown Island Airport – نوكسفيل
KDLC – Dillon County Airport – ديلون
KDLF (DLF) – Laughlin Air Force Base – ديل ريو
KDLH (DLH) – Duluth International Airport – دولوث
KDLL – Baraboo-Wisconsin Dells Airport – بارابو
KDLN – Dillon Airport – ديلون
KDLO – Delano Municipal Airport – ديلانو
KDLS (DLS) – Columbia Gorge Regional Airport – ذا داليس
KDLZ (DLZ) – Delaware Municipal Airport – ديلاوير
KDMA (DMA) – Davis-Monthan Air Force Base – توسان
KDMN (DMN) – Deming Municipal Airport – ديمينغ
KDMO (DMO) – Sedalia Regional Airport – سيداليا
KDMW – Carroll County Regional Airport – وستمنستر
KDNA –Doña Ana County International Jetport – سانتا تيريزا
KDNL – Daniel Field – أوغستا
KDNN – Dalton Municipal Airport – دالتون
KDNS – Denison Municipal Airport – دينيسون
KDNV (DNV) – Vermilion Regional Airport – دانفيل
KDOV (DOV) – Dover Air Force Base – دوفر
KDPA – Dupage Airport – ويست شيكاغو
KDPG – Michael Army Airfield – Dugway Proving Ground، يوتا
KDPL – Duplin County Airport – كينانزفيل
KDQH – Douglas Municipal Airport – دوغلاس
KDRA – Desert Rock Airport – Mercury، Nevada
KDRI (DRI) – Beauregard Regional Airport – ديرايدر
KDRO – Durango-La Plata County Airport – دورانغو
KDRT – Del Rio International Airport – ديل ريو
KDRU – Drummond Airport – دروموند
KDSM (DSM) – Des Moines International Airport – دي موين
KDSV – Dansville Municipal Airport – دانسفيل ليفينغستون مقاطعة
KDTA – Delta Municipal Airport – دلتا
KDTG – Dwight Airport – دوايت
KDTL (DTL) – Detroit Lakes Airport – ديترويت ليكس
KDTN (DTN) – Shreveport Downtown Airport – شريفبورت
KDTO – Denton Enterprise Airport – دينتون
KDTS – Destin Executive Airport – ديستن
KDTW (DTW) – مطار ديترويت – رومولوس (قريب من ديترويت)
KDUA (DUA) – Durant Regional Airport-Eaker Field – ديورانت
KDUC – Halliburton Field – دنكان
KDUG – Bisbee-Douglas International Airport – بيسبي / دوغلاس
KDUH – Toledo Suburban Airport – Lambertville، Michigan
KDUJ (DUJ) – DuBois Regional Airport – دوبويس
KDUX (DUX) – Moore County Airport – دوماس
KDVK – Stuart Powell Field – دانفيل
KDVL (DVL) – Devils Lake Regional Airport – ديفيلز ليك
KDVN – Davenport Municipal Airport – دافنبورت
KDVO – Gnoss Field – نوفاتو
KDVP – Slayton Municipal Airport – سلايتون
KDVT – Phoenix Deer Valley Airport – فينيكس
KDWH – David Wayne Hooks Memorial Airport – سبرينغ
KDWU – Ashland Regional Airport – أشلاند
KDXE – Dexter Municipal Airport – دكستر
KDXR – Danbury Municipal Airport – دانبري
KDXX – Lac qui Parle County Airport – ماديسون
KDYA (DYA) – Demopolis Municipal Airport – ديموبوليس
KDYB (DYB) – Summerville Airport – سامرفيل
KDYL – Doylestown Airport – Doylestown، Pennsylvania
KDYR – Dyersburg Regional Airport – دييرسبورغ
KDYS (DYS) – Dyess Air Force Base – أبيلين
KDYT – Sky Harbor Airport & Seaplane Base – دولوث
KDZJ (DZJ) – Blairsville Airport – بليرسفيل


=== KE ===
KEAG – Eagle Grove Municipal Airport – إيجل غروف
KEAN (EAN) – Phifer Airfield – ويتلاند
KEAR (EAR) – Kearney Regional Airport – كيارني
KEAT – Pangborn Memorial Airport – وينتاتشي
KEAU (EAU) – Chippewa Valley Regional Airport – يو كلير
KEBG (EBG) – South Texas International Airport at Edinburg  – إدينبورغ
KEBS – Webster City Municipal Airport – ويبستر سيتي
KECG (ECG) – Elizabeth City Regional Airport / Elizabeth City CGAS – إليزابيث سيتي
KECP (ECP) – Northwest Florida Beaches International Airport – بنما سيتي
KECS (ECS) – Mondell Field – نيوكاسل
KECU – Edwards County Airport – روكسبرينغز
KEDC – Austin Executive Airport  – أوستن
KEDE (EDE) – Northeastern Regional Airport – إدنتون
KEDG – Weide Army Heliport – أرض الاختبار بمدينة أبردين، أرض الاختبار بمدينة أبردين، ماريلند
KEDJ (EDJ) – Bellefontaine Regional Airport – بيل فونتين
KEDN – Enterprise Municipal Airport – إنتربرايز
KEDU - University Airport - دافيس
KEDW (EDW) – قاعدة إدواردز الجوية – روساموند
KEED – Needles Airport – نيدلز
KEEN (EEN) – Dillant-Hopkins Airport – كين
KEEO – Meeker Airport – ميكر
KEET – Shelby County Airport – ألاباستير
KEFC – Belle Fourche Municipal Airport – بيل فورش
KEFD – Ellington Field Joint Reserve Base – هيوستن
KEFK – Northeast Kingdom International Airport – نيوبورت
KEFT – Monroe Municipal Airport – مونرو
KEFW – Jefferson Municipal Airport – جيفرسون
KEGE (EGE) – Eagle County Regional Airport – إيغل (قريب من فيل)
KEGI – Duke Field – كريستفيو
KEGQ – Emmetsburg Municipal Airport – إميستسبيرغ
KEGT – Wellington Municipal Airport – ولنغتون
KEGV – Eagle River Union Airport – إيغل ريفر
KEHA – Elkhart-Morton County Airport – إلكهارت
KEHO (EHO) – Shelby-Cleveland County Regional Airport – شيلبي
KEHR – Henderson City-County Airport – هندرسون
KEIK – Erie Municipal Airport – إري
KEIW – County Memorial Airport – نيو مدريد
KEKA (EKA) – Murray Field – يوريكا
KEKM – Elkhart Municipal Airport – إلخارت
KEKN (EKN) – Elkins-Randolph County Airport – إلكينز
KEKO (EKO) – Elko Regional Airport – إلكو
KEKQ – Wayne County Airport – مونتايسلو
KEKS (EKS) – Ennis - Big Sky Airport – Ennis، Montana،
KEKX – Elizabethtown Regional Airport – إليزابيثتاون
KEKY – Bessemer Airport – بيسمير
KELA – Eagle Lake Airport – إيغل ليك
KELD (ELD) – South Arkansas Regional Airport at Goodwin Field – إل دورادو
KELK (ELK) – Elk City Regional Business Airport – إلك سيتي
KELM (ELM) – Elmira/Corning Regional Airport – Big Flats، New York (قريب من إلميرا وكورنينغ)
KELN – Bowers Field – إلينسبورغ
KELO (ELO) – Ely Municipal Airport – إلي
KELP (ELP) – El Paso International Airport – إل باسو
KELY – Ely Airport (Yelland Field) – إلي
KELZ – Wellsville Municipal Airport – Wellsville، New York
KEMM (EMM) – Kemmerer Municipal Airport – كمرر
KEMP – Emporia Municipal Airport – إمبوريا
KEMT – San Gabriel Valley Airport – إل مونتي
KEMV – Emporia-Greensville Regional Airport – إمبوريا
KEND (END) – Vance Air Force Base – إنيد
KENL – Centralia Municipal Airport – سينتراليا
KENV – Wendover Airport – ويندوفر
KENW (ENW) – Kenosha Regional Airport – كينوشا
KEOE – Newberry County Airport – نيوبيري
KEOK – Keokuk Municipal Airport – كيوكوك
KEOP – Pike County Airport – ويفرلي
KEOS – Neosho Hugh Robinson Airport – Neosho، Missouri
KEPG – Browns Airport – ويبينغ واتير
KEPH – Ephrata Municipal Airport – إفراتا
KEPM – Eastport Municipal Airport – إيستبورت
KEQA – El_Dorado/Captain Jack Thomas Memorial Airport – إلدورادو
KEQY (EQY) – Monroe Regional Airport – مونرو
KERI (ERI) – Erie International Airport – إيري
KERR – Errol Airport – إيرول
KERV – Kerrville Municipal Airport – كيرفيل
KERY (ERY) – Luce County Airport – نيوبيري
KESC – Delta County Airport – إسكانابا
KESF (ESF) – Esler Regional Airport – الإسكندرية
KESN (ESN) – Easton Airport – ايستون
KEST – Estherville Municipal Airport – إسثرفيل
KESW – Easton State Airport – إيستون
KETB – West Bend Municipal Airport – ويست بيند
KETC – Tarboro-Edgecombe Airport – تاربورو
KETN – Eastland Municipal Airport – إيستلاند
KEUF (EUF) – Weedon Field – يوفولا
KEUG (EUG) – Eugene Airport / Mahlon Sweet Field – يوجين
KEUL – Caldwell Industrial Airport – كالدويل
KEVB – New Smyrna Beach Municipal Airport – نيو سميرنا بيتش
KEVM – Eveleth-Virginia Municipal Airport – إفيليث
KEVU (EVU) – Northwest Missouri Regional Airport – ماريفيل
KEVV (EVV) – Evansville Regional Airport – إيفانسفيل
KEVW (EVW) – Evanston-Uinta County Airport – إيفانستون
KEVY – Summit Airport – ميلدتاون
KEWB (EWB) – New Bedford Regional Airport – نيو بدفورد
KEWK – Newton City/County Airport – نيوتن
KEWN (EWN) – Coastal Carolina Regional Airport – نيوبيرن
KEWR (EWR) – مطار نيوآرك ليبرتي الدولي – نيوآرك وإليزابيث
KEXX (EXX) – Davidson County Airport – ليكسينغتون
KEYE (EYE) – Eagle Creek Airpark – إنديانابوليس
KEYF – Curtis L. Brown Jr. Field – إليزابيثتاون
KEYQ – Weiser Air Park – هيوستن
KEYW (EYW) – Key West International Airport – كي ويست
KEZF – Shannon Airport – فريدريكسبورغ
KEZI – Kewanee Municipal Airport – كيواني
KEZM – Heart of Georgia Regional Airport – إيستمان
KEZS (EZS) – Shawano Municipal Airport – شاوانو
KEZZ – Cameron Memorial Airport – كاميرون


=== KF ===
KFAF – Joint Base Langley-Eustis – Fort Eustis، Virginia
KFAM – Farmington Regional Airport – فارمنغتون
KFAR (FAR) – Hector International Airport – فارغو
KFAT (FAT) – Fresno Yosemite International Airport – فريسنو
KFAY (FAY) – Fayetteville Regional Airport – فايتفيل
KFBG (FBG) – Simmons Army Airfield – Fort Bragg، North Carolina
KFBL – Faribault Municipal Airport – فيرباولت
KFBR (FBR) – Fort Bridger Airport – فورت بريدغر
KFBY – Fairbury Municipal Airport – فايربوري
KFCA/KGPI (FCA) – Glacier Park International Airport – كاليسبيل
KFCH – Fresno Chandler Executive Airport – فريسنو
KFCI – Chesterfield County Airport – ريتشموند
KFCM – Flying Cloud Airport – إيدن بريري
KFCS – Butts Army Airfield – Fort Carson، Colorado
KFCT – Vagabond Army Heliport – ياكيما
KFCY – Forrest City Municipal Airport – فورست سيتي
KFDK – Frederick Municipal Airport – فريدريك
KFDR (FDR) – Frederick Regional Airport – فريدريك
KFDW – Fairfield County Airport – وينسبورو
KFDY – Findlay Airport – فندلي
KFEP – Albertus Airport – فري بورت
KFES – Festus Memorial Airport – فيستوس
KFET – Fremont Municipal Airport – فريمونت
KFFA – First Flight Airport – كيل ديفل هيلز
KFFC – Atlanta Regional Airport – بيتشتري سيتي
KFFL – Fairfield Municipal Airport – فيرفيلد
KFFM – Fergus Falls Municipal Airport – فرغوس فولز
KFFO (FFO) – رايت باترسون – دايتون
KFFT – Capital City Airport – فرانكفورت
KFFZ (FFZ) – Falcon Field – ميسا
KFGU – Collegedale Municipal Airport – كوليجدال
KFGX – Fleming-Mason Airport – فليمينغسبورغ
KFHB – Fernandina Beach Municipal Airport – فرناندينا بيتش
KFHR (FRD) – Friday Harbor Airport – فرايداي هاربور
KFHU (FHU) – Sierra Vista Municipal Airport / Libby Army Airfield – حصن هواشوكا / سييرا فيستا
KFIG – Clearfield-Lawrence Airport – كليرفيلد
KFIT (FIT) – Fitchburg Municipal Airport – فيتشبورغ
KFKA – Fillmore County Airport – بريستون
KFKL (FKL) – Venango Regional Airport – فرانكلين
KFKN – Franklin Municipal-John Beverly Rose Airport – فرانكلين
KFKR – Frankfort Municipal Airport – فرانكفورت
KFKS – Frankfort Dow Memorial Field – فرانكفورت
KFLD – Fond du Lac County Airport – فوند دو لاك
KFLG (FLG) – Flagstaff Pulliam Airport – فلاغستاف
KFLL (FLL) – Fort Lauderdale-Hollywood International Airport – فورت لودرديل / هوليوود
KFLO (FLO) – Florence Regional Airport – فلورنس
KFLP – Marion County Regional Airport – فليبين
KFLV (FLV) – Sherman Army Airfield – Fort Leavenworth، Kansas
KFLX – Fallon Municipal Airport – فالون
KFLY – Meadow Lake Airport – كولورادو سبرينغز
KFME (FME) – Tipton Airport – Fort Meade / أودنتون
KFMH – Otis Air National Guard Base – فالموث
KFMM – مطار فورت مورغان المحلي – Fort Morgan، Colorado
KFMN – Four Corners Regional Airport – فارمينغتون
KFMY (FMY) – Page Field – فورت مايرز
KFMZ – Fairmont State Airfield – فيرمونت
KFNB – Brenner Field – فولس سيتي
KFNL – Fort Collins-Loveland Municipal Airport – فورت كولنز / لوفلاند
KFNT (FNT) – Bishop International Airport – فلينت
KFOA – Flora Municipal Airport – فلورا
KFOD (FOD) – Fort Dodge Regional Airport – فورت دودج
KFOE (FOE) – Topeka Regional Airport – توبيكا
KFOK (FOK) – Francis S. Gabreski Airport – وستهامبتون بيتش
KFOM – Fillmore Municipal Airport – فيلمور
KFOT – Rohnerville Airport – فورتونا
KFOZ – Bigfork Municipal Airport – بيغفورك
KFPK (FPK) – Fitch H. Beach Airport – شارلوت
KFPR (FPR) – Treasure Coast International Airport – فورت بيرس
KFQD – Rutherford County Airport – روذرفوردتون
KFRG (FRG) – Republic Airport – إيست فارمينغدال
KFRH – French Lick Municipal Airport – فرنتش ليك
KFRI (FRI) – Marshall Army Airfield – فورت رايلي / جنكشن سيتي
KFRM – Fairmont Municipal Airport – فيرمونت
KFRR – Front Royal-Warren County Airport – فرونت رويال
KFSD (FSD) – Sioux Falls Regional Airport – سو فولز
KFSE – Fosston Municipal Airport – فوستون
KFSI (FSI) – Henry Post Army Airfield – Fort Sill / لوتون
KFSK – Fort Scott Municipal Airport – فورت سكوت
KFSM (FSM) – Fort Smith Regional Airport – فورت سميث
KFSO – Franklin County State Airport – هايغيت
KFST – Fort Stockton-Pecos County Airport – فورت ستوكتون
KFSU – Fort Sumner Municipal Airport – فورت سانير
KFSW – Fort Madison Municipal Airport – فورت ماديسون
KFTG – Front Range Airport – أورورا
KFTK (FTK) – Godman Army Airfield – فورت نوكس، كنتاكي
KFTT – Elton Hensley Memorial Airport – فولتون
KFTW (FTW) – Fort Worth Meacham International Airport – فورت وورث
KFTY (FTY) – Fulton County Airport – أتلانتا
KFUL – Fullerton Municipal Airport – فوليرتون
KFVE (FVE) – Northern Aroostook Regional Airport – فرنتشفيل
KFVX – Farmville Regional Airport – فارمفيل
KFWA (FWA) – مطار فورت واين الدولي – فورت واين
KFWC – Fairfield Municipal Airport – فيرفيلد
KFWN – Sussex Airport – ساسكس
KFWQ (FWQ) – Rostraver Airport – مونونغاهيلا
KFWS – Fort Worth Spinks Airport – فورت وورث
KFXE – Fort Lauderdale Executive Airport – فورت لودرديل
KFXY – Forest City Municipal Airport – فوريست سيتي
KFYE – Fayette County Airport – سومرفيل
KFYJ (FYJ) – Middle Peninsula Regional Airport – ويست بوينت
KFYM – Fayetteville Municipal Airport – فايتيفيل
KFYV (FYV) – Drake Field – فايتفيل
KFZG – Fitzgerald Municipal Airport – فيتزجيرالد
KFZI – Fostoria Metropolitan Airport – فوستوريا
KFZY – Oswego County Airport – فولتون


=== KG ===
KGAB – Gabbs Airport – غابس
KGAD – Northeast Alabama Regional Airport – غادسدن
KGAF (GAF) – Grafton Municipal Airport – غرافتون
KGAG - Gage Airport - جيج
KGAI – Montgomery County Airpark – غايثرسبيرغ
KGAO – South Lafourche Leonard Miller Jr. Airport – مقاطعة فوورش
KGBD – Great Bend Municipal Airport – غريت بيند
KGBR – Walter J. Koladza Airport – غريت بارينغتون
KGCC (GCC) – Gillette-Campbell County Airport – جيليت
KGCD - Seneca Emergency Airstrip - سينيكا
KGCK (GCK) – Garden City Regional Airport – غاردن سيتي
KGCM - Claremore Regional Airport - كلارمور
KGCN (GCN) – Grand Canyon National Park Airport – متنزه الأخدود العظيم الوطني، أريزونا
KGDJ (GDJ) – Granbury Regional Airport – غرانبوري
KGDM (GDM) – Gardner Municipal Airport – غاردنر
KGDP - Dell City Municipal Airport - ديل سيتي
KGDV – Dawson Community Airport – غلينديف
KGDY – Grundy Municipal Airport – غراندي
KGED – Delaware Coastal Airport – جورجتاون
KGEG (GEG) – Spokane International Airport – سبوكين
KGEU – Glendale Municipal Airport – غلانديل
KGEV – Ashe County Airport – جيفرسون
KGEY (GEY) – South Big Horn County Airport – غريبول
KGFA (GFA) – Malmstrom Air Force Base – غريت فولز
KGFK (GFK) – Grand Forks International Airport – غراند فوركس
KGFL (GFL) – Floyd Bennett Memorial Airport – غلينز فولز
KGGE – Georgetown County Airport – جورجتاون
KGGF – Grant Municipal Airport – غرانت
KGGG (GGG) – East Texas Regional Airport – لونغفيو
KGGI – Grinnell Regional Airport – غرينيل
KGGW (GGW) – Glasgow Airport – غلاسكو
KGHG (GHG) – Marshfield Municipal Airport – مارشفيلد
KGHM – Centerville Municipal Airport – سنترفيل
KGIC - Idaho County Airport - غرانجفيل
KGIF – Winter Haven's Gilbert Airport – وينتر هافن
KGJT (GJT) – Grand Junction Regional Airport – غراند جنكشن
KGKJ – Port Meadville Airport – ميدفيل
KGKT (GKT) – Gatlinburg-Pigeon Forge Airport – مقاطعة سيفير
KGKY – Arlington Municipal Airport – أرلينغتون
KGLD – Goodland Municipal Airport – غودلاند
KGLH (GLH) – Mid Delta Regional Airport – غرينفيل
KGLS (GLS) – Scholes International Airport at Galveston – غالفستون
KGLW – Glasgow Municipal Airport – غلاسكو، كنتاكي
KGMJ - Grove Municipal Airport - غروف
KGMU – Greenville Downtown Airport – غرينفيل
KGNB – Granby-Grand County Airport – غرانبي
KGNC - Gaines County Airport - سيمينول
KGNF – Grenada Municipal Airport – غرينادا
KGNG – Gooding Municipal Airport – غودينغ
KGNI – Grand Isle Seaplane Base – غراند إيسل
KGNT – Grants-Milan Municipal Airport – غرانتس
KGNV (GNV) – Gainesville Regional Airport – غينزفيل
KGOK - Guthrie-Edmond Regional Airport - غوثري
KGON (GON) – Groton-New London Airport – Groton / نيو لندن
KGOO – Nevada County Air Park – غراس فالي
KGOV – Grayling Army Airfield – غرايلينغ
KGPI - انظر KFCA
KGPT (GPT) – Gulfport-Biloxi International Airport – غولفبورت
KGPZ (GPZ) – Grand Rapids-Itasca County Airport – غراند رابيدز
KGRB (GRB) – Austin Straubel International Airport – غرين باي
KGRD – Greenwood County Airport – غرينوود
KGRF (GRF) – Gray Army Airfield – Fort Lewis، Washington
KGRI (GRI) – Central Nebraska Regional Airport – غراند إيسلاند
KGRK (GRK) – Killeen-Fort Hood Regional Airport / Gray Army Airfield – فورت هود، كيلين
KGRN – غوردن (نبراسكا) – غوردن
KGRR (GRR) – Gerald R. Ford International Airport – غراند رابيدز
KGSB (GSB) – قاعدة سيمور جونسون الجوية – غولدزبورو
KGSO (GSO) – Piedmont Triad International Airport – غرينزبورو
KGSP (GSP) – Greenville-Spartanburg International Airport – غرير
KGSW – Greater Southwest International Airport – فورت وورث (أغلق في 1970)
KGTB (GTB) – Wheeler-Sack Army Airfield – فورت درم
KGTE – Gothenburg Municipal Airport – غوثينبورغ
KGTF (GTF) – Great Falls International Airport – غريت فولز
KGTG – Grantsburg Municipal Airport – غرانتسبورغ
KGTR – Golden Triangle Regional Airport – كولومبوس
KGTU – Georgetown Municipal Airport – جورجتاون
KGUC (GUC) – Gunnison-Crested Butte Regional Airport – غونيسون
KGUP (GUP) – Gallup Municipal Airport – غالوب
KGUS (GUS) – Grissom Air Reserve Base – بيرو
KGUY - Guymon Municipal Airport - غيمون
KGVE – Gordonsville Municipal Airport – غوردونسفيل
KGVQ – Genesee County Airport – باتافيا
KGVT – Majors Airport – غرينفيل
KGWB – DeKalb County Airport – أوبرن
KGWO (GWO) – Greenwood-Leflore Airport – غرينوود
KGWR – Gwinner-Roger Melroe Field – غوينر
KGWS – Glenwood Springs Municipal Airport – غلينوود سبرينغز
KGWW (GWW) – Goldsboro-Wayne Municipal Airport – غولدزبورو
KGXA - Gray Butte Field - لاك لوس أنجيلس
KGXF – Gila Bend Air Force Auxiliary Field – غيلا بيند
KGXY – Greeley-Weld County Airport – غريلي
KGYB – Giddings-Lee County Airport – غيدينغز
KGYH – Donaldson Center Airport – غرينفيل
KGYI (GYI) – North Texas Regional Airport – دنيسون
KGYR – Phoenix Goodyear Airport – غوديير
KGYY (GYY) – Gary/Chicago International Airport – غاري
KGZH – Middleton Field – إيفرغرين
KGZL - Stigler Regional Airport - ستيغلر


=== KH ===
KHAB – Marion County – Rankin Fite Airport – هاميلتون
KHAE (HAE) – Hannibal Regional Airport – هانيبال
KHAF – Eddie Andreini Sr. Airfield – هالف موون باي
KHAI (HAI) – Three Rivers Municipal/Doctor Haines Airport – ثري ريفر
KHAO (HAO) – Butler County Regional Airport – هاملتن
KHAR – Harford Airport – كاسبر
KHBC – Mohall Municipal Airport – موهال
KHBG – Hattiesburg Bobby L. Chain Municipal Airport – هاتيسبورغ
KHBI – Asheboro Regional Airport – آشبورو
KHBR - Hobart Regional Airport - هوبارت
KHCR - Russ McDonald Field - هيبر سيتي
KHBZ – Heber Springs Municipal Airport – هيبير سبرينغز
KHCD – Hutchinson Municipal Airport – هوتشينسون
KHDE – Brewster Field – هولدريج
KHDN (HDN) – Yampa Valley Airport – هايدن
KHDO (HDO) – South Texas Regional Airport at Hondo – هوندو
KHEE – Thompson-Robbins Airport – Helena، Arkansas
KHEF – Manassas Regional Airport – ماناساس
KHEG – Herlong Recreational Airport – جاكسونفيل
KHEI – Hettinger Municipal Airport – هتينغر
KHEQ – Holyoke Airport – هوليوك
KHEY (HEY) – Hanchey Army Heliport – فور ركر / أوزارك
KHEZ – Natchez-Adams County Airport – ناتشيز
KHFD (HFD) – Hartford-Brainard Airport – هارتفورد
KHFF – Mackall Army Airfield – Camp Mackall، North Carolina
KHFJ – Monett Municipal Airport – مونيت
KHGR (HGR) – Hagerstown Regional Airport – هاجرستاون
KHHF - Hemphill County Airport - كنديان
KHHR (HHR) – Hawthorne Municipal Airport – هاوثورني
KHHW - Stan Stamper Municipal Airport - هوغو
KHIB (HIB) – Range Regional Airport – هيبينغ
KHIE – Mount Washington Regional Airport – Whitefield، New Hampshire
KHIF (HIF) – Hill Air Force Base – أوغدن
KHII – Lake Havasu City Airport – ليك هافاسو سيتي
KHIO – Hillsboro Airport – بورتلاند
KHJH – Hebron Municipal Airport – هيبرون
KHJO (HJO) – Hanford Municipal Airport – هانفورد
KHKA – Blytheville Municipal Airport – بليثفيل
KHKS – Hawkins Field – جاكسون
KHKY (HKY) – Hickory Regional Airport – هيكري
KHLC – Hill City Municipal Airport – هيل سيتي
KHLG – Wheeling-Ohio County Airport – ويلينغ
KHLN (HLN) – Helena Regional Airport – هيلينا
KHLR (HLR) – Hood Army Airfield – فورت هود / كيلين
KHLX – Twin County Airport – Galax-Hillsville، Virginia
KHMN (HMN) – Holloman Air Force Base – ألاموغوردو
KHMS - Richland Airport - ريتشلاند
KHMT – Hemet-Ryan Airport – هيميت
KHMZ – Bedford County Airport – بيدفورد
KHND (HSH) – Henderson Executive Airport – هندرسون
KHNZ – Henderson-Oxford Airport – أوكسفورد
KHOB (HOB) – Lea County Regional Airport – هوبز
KHOE – Homerville Airport – هوميرفيل
KHON (HON) – Huron Regional Airport – هورون
KHOP (HOP) – Campbell Army Airfield – Fort Campbell، Kentucky
KHOT (HOT) – Memorial Field Airport – هت سبرينغز
KHOU (HOU) – William P. Hobby Airport – هيوستن
KHPN (HPN) – Westchester County Airport – وايت بلينس
KHQG – Hugoton Municipal Airport – هوغوتون
KHQM (HQM) – Bowerman Airport – هوكويام
KHQU – Thomson-McDuffie County Airport – طومسون
KHQZ (HQZ) – Mesquite Metro Airport – مسكيت
KHRI – Hermiston Municipal Airport – هيرميستون
KHRJ (HRJ) – Harnett Regional Jetport – إيروين
KHRL (HRL) – Valley International Airport – هارلينغن
KHRO (HRO) – Boone County Airport – هاريسون
KHRT – Hurlburt Field – مقاطعة أكلووسا
KHRU (HRU) – Herington Regional Airport – هرينغتون
KHRX - Hereford Municipal Airport - هيرفورد
KHSA – Stennis International Airport – باي سانت لويس
KHSE – Billy Mitchell Airport – Hatteras، North Carolina
KHSI – Hastings Municipal Airport – هاستينغس
KHSP (HSP) – Ingalls Field – Hot Springs، Virginia
KHSR – Hot Springs Municipal Airport – هت سبرينغز
KHST (HST) – Homestead Air Reserve Base – هومستيد
KHSV (HSV) – مطار هنتسفيل الدولي (Carl T. Jones Field) – هنتسفيل
KHTH (HTH) – Hawthorne Industrial Airport – هاوثورن
KHTO (HTO) – East Hampton Airport – إيست هامبتون
KHTS (HTS) – Tri-State Airport – هنغتينغتون
KHUA (HUA) – Redstone Army Airfield – ريدستون أرسنال / هنتسفيل
KHUF (HUF) – مطار تير هوت الدولي – تير هوت
KHUL – Houlton International Airport – بلدية هلتون
KHUM – Houma-Terrebonne Airport – هوما
KHUT (HUT) – Hutchinson Municipal Airport – هتشنسون
KHVC – Hopkinsville-Christian County Airport – هوبكينزفيل
KHVE – Hanksville Airport – هانكسفيل
KHVN (HVN) – Tweed-New Haven Airport – نيو هيفن
KHVR – Havre City County Airport – هافري
KHVS – Hartsville Regional Airport – هارتسفيل
KHWD (HWD) – Hayward Executive Airport – هايوارد
KHWO – North Perry Airport – هوليوود
KHWQ – Wheatland County Airport – هارلوتون
KHWV (WSH) – Brookhaven Airport – شيرلي
KHWY (HWY) – Warrenton-Fauquier Airport – وارينتون
KHXD – Hilton Head Airport – جزيرة هيلتون هيد
KHXF – Hartford Municipal Airport – هارتفورد
KHYA (HYA) – Barnstable Municipal Airport – هاينيس
KHYI – San Marcos Regional Airport – سان ماركوس
KHYR – Sawyer County Airport – هايوارد
KHYS (HYS) – Hays Regional Airport – هايز
KHYW – Conway-Horry County Airport – كونواي
KHYX – Saginaw County H.W. Browne Airport – ساغيناو
KHZE – Mercer County Regional Airport – هازين
KHZL – Hazleton Regional Airport – هازلتون


=== KI ===
KIAB (IAB) – McConnell Air Force Base – ويتشيتا
KIAD (IAD) – مطار واشنطن دولس الدولي – دولس
KIAG (IAG) – Niagara Falls International Airport – نياجارا فولز
KIAH (IAH) – مطار جورج بوش الدولي – هيوستن
KIBM – Kimball Municipal Airport – كيمبال
KICR (ICR) – Winner Regional Airport – وينر
KICT (ICT) – Wichita Dwight D. Eisenhower National Airport – ويتشيتا
KIDA (IDA) – Idaho Falls Regional Airport – أيداهو فولز
KIDI – Indiana County-Jimmy Stewart Airport – إنديانا
KIDL – Indianola Municipal Airport – إنديانولا
KIDP – Independence Municipal Airport – إنديبيندنس
KIEN - Pine Ridge Airport - Pine Ridge، South Dakota
KIFP (IFP) – Laughlin/Bullhead International Airport – بولهيد سيتي
KIGM (IGM) – Kingman Airport – كينغمان
KIGX – Horace Williams Airport – تشابل هيل
KIIB – Independence Municipal Airport – إنديبيندينس
KIIY – Washington-Wilkes County Airport – واشنطن
KIJD – Windham Airport – ويليمانتيك
KIJX – Jacksonville Municipal Airport  - جاكسونفيل
KIKV (IKV) – Ankeny Regional Airport – أنكيني
KIKW (IKW) – Jack Barstow Municipal Airport – ميدلاند
KILE (ILE) – Skylark Field – كيلين
KILG (ILG) – Wilmington Airport – ويلمنغتون
KILM (ILM) – Wilmington International Airport – ويلمينغتون
KILN (ILN) – Wilmington Air Park – ويلمنغتون
KIML – Imperial Municipal Airport – إمبريال
KIMM (IMM) – Immokalee Airport – Immokalee، Florida
KIMS – Madison Municipal Airport – ماديسون
KIMT (IMT) – Ford Airport – آيرن ماونتين، ميزوري
KIND (IND) – مطار إنديانابوليس الدولي – إنديانابوليس
KINJ (INJ) – Hillsboro Municipal Airport – هيلزبورو
KINK - Winkler County Airport - كيرميت
KINL (INL) - Falls International Airport - إنترناشونال فولز
KINS – Creech Air Force Base – إنديان سبرينغز
KINT (INT) – Smith Reynolds Airport – وينستون-سالم
KINW (INW) – Winslow-Lindbergh Regional Airport – وينسلو
KIOW – Iowa City Municipal Airport – آيوا سيتي
KIPJ – Lincolnton-Lincoln County Regional Airport – لينكنتون
KIPL – Imperial County Airport – إمبيريال
KIPT (IPT) – Williamsport Regional Airport – ويليامسبورت
KIRK (IRK) – Kirksville Regional Airport – كيركفيل
KISM (ISM) – Kissimmee Gateway Airport – كيسيمي
KISN – Sloulin Field International Airport – ويليستون (أغلق في 2019)
KISO – Kinston Regional Jetport – كينستون
KISP (ISP) – Long Island MacArthur Airport – رونكونكوما
KISW – South Wood County Airport – ويسكونسن رابيدز
KITH (ITH) – Ithaca Tompkins International Airport – إثاكا
KITR – Kit Carson County Airport – برلنغتون
KIWA (AZA) – Phoenix-Mesa Gateway Airport – ميسا
KIWI – Wiscasset Airport – Wiscasset، Maine
KIWD (IWD) – Gogebic-Iron County Airport – أيرونوود
KIXD – New Century AirCenter – أولاث
KIYK – Inyokern Airport – Inyokern، California
KIZA – Santa Ynez Airport – Santa Ynez، California
KIZG – Eastern Slopes Regional Airport – فرايبورغ


=== KJ ===
KJAC (JAC) – Jackson Hole Airport – Jackson Hole، Wyoming
KJAN (JAN) – Jackson International Airport – جاكسون
KJAX (JAX) – مطار جاكسونفيل الدولي – جاكسونفيل
KJBR (JBR) – Jonesboro Municipal Airport – جونزبورو
KJCT - Kimble County Airport - جنكشن
KJDN – Jordan Airport – جورادن
KJEF – Jefferson City Memorial Airport – جفرسون سيتي
KJFK (JFK) – مطار جون إف كينيدي الدولي – نيويورك
KJFX – Walker County Airport – جاسبر
KJER – Jerome County Airport – جيروم
KJGG – Williamsburg-Jamestown Airport – ويليامزبرغ
KJHN – Stanton County Municipal Airport – جونسون سيتي
KJHW – Chautauqua County-Jamestown Airport – جيمستاون
KJKA (GUF) – Jack Edwards Airport – غلف شورز
KJLN (JLN) – Joplin Regional Airport – جوبلن
KJMS (JMS) – Jamestown Regional Airport – جيمستاون
KJNX – Johnston Regional Airport – سميثفيلد
KJQF (JQF) – Concord Regional Airport – كونكورد
KJRA – West 30th Street Heliport – مانهاتن، نيويورك، نيويورك
KJRB (JRB) – Downtown Manhattan Heliport – مانهاتن، نيويورك، نيويورك
KJST (JST) – Johnstown-Cambria County Airport – جونستاون
KJSV - Sallisaw Municipal Airport - ساليسو
KJVW – John Bell Williams Airport – ريموند
KJWG - Watonga Regional Airport - واتونغا
KJWN - John C. Tune Airport - ناشفيل
KJYO (JYO) – Leesburg Executive Airport – ليسبورغ
KJYR – York Municipal Airport – يورك
KJZI – Charleston Executive Airport – تشارلستون
KJZP – Pickens County Airport – جاسبير


=== KK ===
KKIC – Mesa Del Rey Airport – كينغ سيتي
KKLS (KLS) – Southwest Washington Regional Airport – كيلسو
KKNB (KNB) – Kanab Municipal Airport – كاناب
KKY8 (KY8) - Hancock County Airport - لويسبورت


=== KL ===
KLAA – Lamar Municipal Airport – لامار
KLAF (LAF) – Purdue University Airport – ويست لافاييت
KLAL (LAL) – Lakeland Linder International Airport – ليكلاند
KLAM – Los Alamos Airport – لوس ألاموس
KLAN (LAN) – Capital Region International Airport – لانسنغ
KLAR (LAR) – Laramie Regional Airport – لارامي
KLAS (LAS) – مطار هاري ريد الدولي – لاس فيغاس
KLAW - Lawton-Fort Sill Regional Airport - لوتون
KLAX (LAX) – مطار لوس أنجلوس الدولي – لوس أنجلوس
KLBB (LBB) – Lubbock Preston Smith International Airport – لوبوك
KLBE (LBE) – Arnold Palmer Regional Airport – لاتروب
KLBF (LBF) – North Platte Regional Airport – نورث بلات
KLBL (LBL) – Liberal Municipal Airport – ليبرال
KLBR (LBR) – Clarksville/Red River County Airport – كلاركسفيل
KLBT – Lumberton Municipal Airport – لومبيرتون
KLCG – Wayne Municipal Airport – وين
KLCH (LCH) – Lake Charles Regional Airport – ليك تشارلز
KLCI – Laconia Municipal Airport – لاكونيا
KLCK (LCK) – Rickenbacker International Airport – كولومبوس
KLCQ – Lake City Gateway Airport – ليك سيتي
KLDJ – Linden Airport – ليندن
KLDM (LDM) – Mason County Airport – لودينغتون
KLEB (LEB) – Lebanon Municipal Airport – West Lebanon، New Hampshire
KLEE (LEE) – Leesburg International Airport – ليسبرغ
KLEM – Lemmon Municipal Airport – ليمون
KLEW – Auburn/Lewiston Municipal Airport – أوبورن
KLEX – Blue Grass Airport – ليكسينغتون
KLFI – Langley Air Force Base – هامبتون
KLFK – Angelina County Airport – لوفكين
KLFT – Lafayette Regional Airport – لافاييت
KLGA – مطار لاغوارديا – نيويورك
KLGB – Long Beach Airport – لونغ بيتش
KLGD – La Grande/Union County Airport – لا غراندي
KLGF (LGF) – Laguna Army Airfield – يوما
KLGU – Logan-Cache Airport – لوغان
KLHB – Hearne Municipal Airport – هيرن
KLHM – Lincoln Regional Airport – لينكون
KLHQ – Fairfield County Airport – لانكستر
KLHV – William T. Piper Memorial Airport – لوك هيفن، بنسيلفانيا
KLHX – La Junta Municipal Airport – لا جونتا
KLHZ – Triangle North Executive Airport – لويسبرغ
KLIC – Limon Municipal Airport – ليمون
KLIT – مطار ليتل روك الدولي – ليتل روك
KLKP – Lake Placid Airport – ليك بلاسيد
KLKR – Lancaster County Airport – لانكستر
KLKU – Louisa County Airport – لوييسا
KLKV – Lake County Airport – ليكفيو
KLLJ – Challis Airport – شاليس
KLLQ – Monticello Municipal Airport – مونتايسلو
KLLU – Lamar Municipal Airport – لامار
KLMO – Vance Brand Airport – لونغمونت
KLMS – Louisville Winston County Airport – لويزفيل
KLMT – Crater Lake-Klamath Regional Airport – كلاماث فالز
KLNA – Palm Beach County Park Airport – ويست بالم بيتش
KLNC – Lancaster Regional Airport – لانكستر
KLND – Hunt Field – لاندر
KLNK – Lincoln Airport – لنكن
KLNN – Lost Nation Airport – ويلوبي
KLNP – Lonesome Pine Airport – وايز
KLNS – Lancaster Airport – لانكستر
KLOL – Derby Field – لوفلوك
KLOR (LOR) – Lowe Army Heliport – فور ركر / أوزارك
KLOT (LOT) – Lewis University Airport – روميوفيل
KLOU – Bowman Field – لويفيل
KLOZ – London-Corbin Airport – لندن
KLPC – Lompoc Airport – لومبوك
KLPR – Lorain County Regional Airport – لورين
KLQK – Pickens County Airport – بيكنز
KLQR – Larned-Pawnee County Airport – لارنيد
KLRD (LRD) – Laredo International Airport – لاريدو
KLRF – Little Rock Air Force Base – جاكسونفيل
KLRG – Lincoln Regional Airport – لينكولن
KLRU – Las Cruces International Airport – لاس كروسيس
KLSB – Lordsburg Municipal Airport – لوردزبورغ
KLSE (LSE) – La Crosse Regional Airport – لاكروس
KLSF – Lawson Army Airfield – Fort Benning، مقاطعة تشاتاهوتشي
KLSK – Lusk Municipal Airport – لاسك
KLSN – Los Banos Municipal Airport – لوس بانوس
KLSV (LSV) – Nellis Air Force Base – لاس فيغاس
KLTS – (LTS) Altus Air Force Base – ألتوس
KLTY – Liberty County Airport – تشيستر
KLUF (LUF) – Luke Air Force Base – غلانديل
KLUG – Ellington Airport – لويسبورغ
KLUK (LUK) - Cincinnati Municipal Lunken Airport - سينسيناتي
KLUL – هيسلر نوبل فيلد – لاوريل
KLVK – Livermore Municipal Airport – ليفرمور
KLVL – Lawrenceville/Brunswick Municipal Airport – لاورنسفيل
KLVM – Mission Field – ليفينغستون
KLVN – Airlake Airport – ليكفيل
KLVS (LVS) – Las Vegas Municipal Airport – لاس فيغاس
KLWB – Greenbrier Valley Airport – لويسبرغ
KLWC – Lawrence Municipal Airport – لورانس
KLWL – Wells Municipal Airport – ويلز
KLWM – Lawrence Municipal Airport – لورانس
KLWS – Lewiston-Nez Perce County Airport – لويستون
KLWT – Lewistown Municipal Airport – لويستاون
KLWV – Lawrenceville-Vincennes International Airport – لورينسيفيل
KLXL – Little Falls/Morrison County Airport – ليتل فولز
KLXN – Jim Kelly Field – ليكسنغتون
KLXT – Lee's Summit Municipal Airport – ليز ساميت
KLXV – Lake County Airport – ليدفيل
KLYH – Lynchburg Regional Airport – لينشبرغ
KLYO – Lyons-Rice County Municipal Airport – ليونز
KLZU – Gwinnett County Airport – لورينسفيل
KLZZ – Lampasas Airport – لامبساس


=== KM ===
KMAC (MAC) – Macon Downtown Airport – ماكون
KMAE – Madera Municipal Airport – ماديرا
KMAF (MAF) – Midland International Air and Space Port – مدلاند
KMAI – Marianna Municipal Airport – ماريانا
KMAL – Malone-Dufort Airport – قرية مالون
KMAN - Nampa Municipal Airport - نامبا
KMAO – Marion County Airport – ماريون
KMAW – Malden Municipal Airport – مالدن، ميزوري
KMBG – Mobridge Municipal Airport – موبريدج
KMBO – Campbell Airport – ماديسون
KMBS (MBS) – MBS International Airport – ميدلاند / باي سيتي / ساغيناو
KMBT (MBT) – Murfreesboro Municipal Airport – مورفريسبورو
KMCB (MCB) – McComb-Pike County Airport – ماكومب
KMCC (MCC) – McClellan Airfield – ساكرامنتو
KMCE – Merced Regional Airport – ميرسيد
KMCF (MCF) – MacDill Air Force Base – تامبا
KMCI (MCI) – Kansas City International Airport – كانساس سيتي
KMCK (MCK) – McCook Ben Nelson Regional Airport – ماكوك
KMCN (MCN) – Middle Georgia Regional Airport – ماكون
KMCO (MCO) – مطار أورلاندو الدولي – أورلاندو
KMCW – Mason City Municipal Airport – ماسون سيتي
KMCZ – Martin County Airport – ويليامستون
KMDD - Midland Airpark - مدلاند
KMDQ – Madison County Executive Airport – هنتسفيل
KMDS – Madison Municipal Airport – ماديسون
KMDT (MDT) – Harrisburg International Airport – ميدلتاون
KMDW (MDW) – مطار ميدواي الدولي – شيكاغو
KMDZ – Taylor County Airport – ميدفورد
KMEB – Laurinburg-Maxton Airport – ماكستون
KMEI (MEI) – Meridian Regional Airport – ميريديان
KMEJ – Meade Municipal Airport – ميد
KMEM (MEM) – مطار ممفيس الدولي – ممفيس
KMER (MER) – Castle Airport – أتووتر
KMEV – Minden–Tahoe Airport – ميندين
KMFE (MFE) – McAllen-Miller International Airport – ماكالين
KMFI – Marshfield Municipal Airport (Wisconsin) – مارشفيلد
KMFR (MFR) – Rogue Valley International-Medford Airport – ميدفورد
KMFV – Accomack County Airport – ميلفا
KMGE (MGE) – Dobbins Air Reserve Base – ماريتا
KMGG – Maple Lake Municipal Airport – مابل ليك
KMGJ – Orange County Airport – مونتغمري
KMGM (MGM) – Montgomery Regional Airport – مونتغومري
KMGW (MGW) – Morgantown Municipal Airport – مورغانتاون
KMGY (MGY) – Dayton Wright Brothers Airport – دايتون
KMHE (MHE) – Mitchell Municipal Airport – ميتشل
KMHK (MHK) – Manhattan Regional Airport – مانهاتن
KMHL – Marshall Memorial Municipal Airport – مارشال
KMHN – Hooker County Airport – مولين
KMHR (MHR) – Sacramento Mather Airport – ساكرامنتو
KMHS - Dunsmuir Municipal-Mott Airport - موونت شاستا
KMHT (MHT) – Manchester-Boston Regional Airport – مانشستر
KMHV – Mojave Air and Space Port – موهافي
KMIA (MIA) – مطار ميامي الدولي – ميامي
KMIB (MIB) – Minot Air Force Base – مينوت
KMIC – Crystal Airport – كريستال
KMIO – Miami Municipal Airport – ميامي
KMIT – Shafter Airport – شافتير
KMIV (MIV) – Millville Executive Airport – ميلفيل، نيوجيرسي
KMJX – Robert J. Miller Air Park – Toms River، New Jersey
KMKA – Miller Municipal Airport – ميلر
KMKC (MKC) – Charles B. Wheeler Downtown Airport – كانساس سيتي
KMKE (MKE) – Milwaukee Mitchell International Airport – ميلواكي
KMKG (MKG) – Muskegon County Airport – مسكيغون
KMKJ – Mountain Empire Airport – ماريون / ويثفيل
KMKL (MKL) – McKellar-Sipes Regional Airport – جاكسون
KMKO - Davis Field - موسكوجي
KMKT (MKT) – Mankato Regional Airport – مانكيتو
KMKY – Marco Island Airport – نيبلز
KMLB (MLB) – Melbourne Orlando International Airport – ملبورن
KMLC - McAlester Regional Airport - ماكالستر
KMLD – Malad City Airport – مالاد سيتي
KMLE - Millard Airport - أوماها
KMLF (MLF) – Milford Municipal Airport – ميلفورد
KMLI (MLI) – Quad Cities International Airport – مولين
KMLS (MLS) – Miles City Municipal Airport – مايلز سيتي
KMLT – Millinocket Municipal Airport – ميلينكوت
KMLU (MLU) – Monroe Regional Airport – مونرو
KMMH (MMH) – Mammoth Yosemite Airport – ماموث لاكيس
KMMI – McMinn County Airport – أثينا
KMMK – Meriden Markham Municipal Airport – ميريديان
KMML (MML) – Southwest Minnesota Regional Airport – مارشال
KMMS – Selfs Airport – ماركس
KMMT – McEntire Joint National Guard Base – إيستوفر
KMMU (MMU) – Morristown Municipal Airport – موريستاون
KMMV (MMV) – McMinnville Municipal Airport – ميكمينفيل
KMNI – Santee Cooper Regional Airport – مانينغ
KMNZ – Hamilton Municipal Airport – هاميلتون
KMOB (MOB) – مطار موبيل الإقليمي – موبيل
KMOD (MOD) – Modesto City-County Airport – موديستو
KMOR – Morristown Regional Airport – موريستاون
KMOT (MOT) – Minot International Airport – مينوت
KMPE – Philadelphia Municipal Airport – فيلادلفيا
KMPI (MPI) – Mariposa-Yosemite Airport – Mariposa، California
KMPJ – Petit Jean Park Airport – موريلتون
KMPO – Pocono Mountains Municipal Airport – ماونت بوكونو
KMPR – McPherson Airport – ماكفرسون
KMPV – Edward F. Knapp State Airport – باري-مونبلييه
KMQI – Dare County Regional Airport – مانتيو
KMQJ (MQJ) – Indianapolis Regional Airport – إنديانابوليس
KMQS (CTH) – Chester County G. O. Carlson Airport – كوتسفيل
KMQY (MQY) – Smyrna Airport – سميرنا
KMRB (MRB) – Eastern West Virginia Regional Airport – مرتينسبورغ
KMRF - Marfa Municipal Airport - مارفا
KMRH – Michael J. Smith Field – بوفورت
KMRN (MRN) – Foothills Regional Airport – مورغانتون
KMRY (MRY) – Monterey Regional Airport – مونتيري
KMSL (MSL) – Northwest Alabama Regional Airport – مسل شولس
KMSN (MSN) – Dane County Regional Airport – ماديسون
KMSO (MSO) – Missoula International Airport – ميسولا
KMSP (MSP) – مطار منيابولس-سنت بول الدولي – بلومنغتون
KMSS (MSS) – Massena International Airport – قرية ماسينا
KMSV – Sullivan County International Airport – مونتيسيلو
KMSY (MSY) – مطار نيو اورليانز لويس أرمسترونغ الدولي – نيو أورلينز
KMTC (MTC) – Selfridge Air National Guard Base – ماونت كليمنس
KMTH (MTH) – Florida Keys Marathon Airport – ماراثون
KMTJ – Montrose Regional Airport – مونتروز
KMTN (MTN) – Martin State Airport – بالتيمور
KMTP (MTP) – Montauk Airport – مونتوك
KMTV – Blue Ridge Airport – مارتينسفيل
KMTW – Manitowoc County Airport – مانيتووك
KMUO (MUO) – Mountain Home Air Force Base – ماونتين هوم
KMUT – Muscatine Municipal Airport – موسكاتاين
KMUU – Huntingdon County Airport – Mount Union، Pennsylvania (مغلق)
KMVC (MVC) – Monroe County Airport – مونروفيل
KMVI – Monte Vista Municipal Airport – مونتي فيستا
KMVL – Morrisville-Stowe State Airport – موريسفيل
KMVM – Machias Valley Airport – ماتشياس
KMVY (MVY) – Martha's Vineyard Airport – فينيارد هافن
KMWH – Grant County International Airport – موسيس ليك
KMWC - Lawrence J. Timmerman Airport - ميلواكي
KMWK – Mount Airy/Surry County Airport – ماونت إيري
KMWL – Mineral Wells Airport – مينيرال ويلز
KMXA – Manila Municipal Airport – مانيلا
KMXF (MXF) – Maxwell Air Force Base – مونتغومري
KMXO – Monticello Regional Airport – مونتايسلو
KMYF – Montgomery-Gibbs Executive Airport – سان دييغو
KMYL – McCall Municipal Airport – ماكال
KMYR (MYR) – Myrtle Beach International Airport – ميرتل بيتش
KMYV (MYV) – Yuba County Airport – ماريسفيل
KMYZ – Marysville Municipal Airport – ماريسفيل
KMZJ (MZJ) – Pinal Airpark – مارانا


=== KN ===
KNAB – Naval Air Station Albany – ألباني
KNBC (BFT) – Marine Corps Air Station Beaufort – بيافورت
KNBG (NBG) - Naval Air Station Joint Reserve Base New Orleans - بيل شاس
KNBJ (NHX) – Naval Outlying Landing Field Barin – فولي
KNBW (NBW) – Leeward Point Field – خليج غوانتانامو
KNCA (NCA) – Marine Corps Air Station New River – جاكسونفيل
KNDY – Naval Surface Warfare Center Dahlgren – داهلغرين
KNDZ - Naval Air Station Whiting Field South - Milton، Florida
KNEL (NEL) – Naval Air Engineering Station Lakehurst – لاكهورست
KNEN – Naval Outlying Landing Field Whitehouse – جاكسونفيل
KNEW (NEW) – Lakefront Airport – نيو أورلينز
KNFD – Naval Outlying Landing Field Summerdale – سامرديل
KNFE – Naval Auxiliary Landing Field Fentress – تشيسابيك
KNFG (NFG) – Marine Corps Air Station Camp Pendleton – Camp Pendleton، California
KNFJ – Naval Outlying Landing Field Choctaw – ميلتون
KNFL (NFL) – Naval Air Station Fallon – فالون
KNFW – Naval Air Station Joint Reserve Base Fort Worth – فورت وورث
KNGP (NGP) – Naval Air Station Corpus Christi – كوربوس كريستي
KNGS – Naval Outlying Landing Field Santa Rosa – ميلتون
KNGU (NGU) – Naval Station Norfolk – نورفولك
KNGZ – Naval Air Station Alameda – ألاميدا
KNHK (NHK) – Naval Air Station Patuxent River – Patuxent River، Maryland
KNHL – Naval Outlying Landing Field Wolf – فولي
KNHZ – Naval Air Station Brunswick – برونزويك
KNID – Naval Air Weapons Station China Lake – ريدجكريست
KNIP (NIP) – Naval Air Station Jacksonville – جاكسونفيل
KNJK (NJK) – Naval Air Facility El Centro – إل سنترو
KNJM – Marine Corps Auxiliary Landing Field Bogue – Swansboro، North Carolina
KNJW – Naval Outlying Landing Field Joe Williams – ميريديان
KNKL – Naval Outlying Landing Field Holley – فورت والتون بيتش
KNKT (NKT) – Marine Corps Air Station Cherry Point – Cherry Point، North Carolina
KNKX (NKX) – Marine Corps Air Station Miramar – سان دييغو
KNLC – Naval Air Station Lemoore – ليمووري
KNMM (NMM) – Naval Air Station Meridian – ميريديان
KNOW – Coast Guard Air Station Port Angeles – بورت أنجلوس
KNPA (NPA) – Naval Air Station Pensacola – بينساكولا
KNPI – Naval Outlying Landing Field Site 8 – بينساكولا
KNQA (NQA) – Millington Regional Jetport – ميلينجتون
KNQB – Naval Outlying Landing Field Silverhill – روبرتسديل
KNQX (NQX) – Naval Air Station Key West – Boca Chica Key، Florida
KNRA – Naval Outlying Landing Field Coupeville – كوبيفيل
KNRB – Naval Station Mayport – جاكسونفيل
KNRN – Norton Municipal Airport – نورتون
KNRQ – Naval Outlying Landing Field Spencer – Pace، Florida
KNRS – Naval Outlying Landing Field Imperial Beach – إمبيريال بيتش
KNSE - Naval Air Station Whiting Field North - Milton، Florida
KNSI – Naval Outlying Landing Field San Nicolas Island – San Nicolas Island، California
KNTD (NTD) – Naval Air Station Point Mugu – أوكسنارد
KNTK – Marine Corps Air Station Tustin – سانتا آنا
KNTU (NTU) – Naval Air Station Oceana – فرجينيا بيتش
KNUC – Naval Auxiliary Landing Field San Clemente Island – سان كليمينتي
KNUI – Naval Outlying Landing Field Webster – Saint Inigoes، Maryland
KNUN – Naval Outlying Landing Field Saufley – بينساكولا
KNUQ (NUQ) – Moffett Federal Airfield – ماونتن فيو
KNUW – Naval Air Station Whidbey Island – أوك هاربور
KNVI – Naval Outlying Landing Field Pace – Wallace، Florida
KNWL – Naval Outlying Landing Field Waldron – كوربوس كريستي
KNYG – Marine Corps Air Facility Quantico – كوانتيكو
KNYL (YUM) – Yuma International Airport / Marine Corps Air Station Yuma – يوما
KNXF – Marine Corps Outlying Field (Red Beach) Camp Pendleton - Camp Pendleton، California
KNXP – Marine Corps Air Ground Combat Center Twentynine Palms – توينتينين بالمس
KNXX – Naval Air Station Joint Reserve Base Willow Grove – Willow Grove، Pennsylvania
KNZJ – Marine Corps Air Station El Toro – سانتا آنا
KNZY (NZY) – Naval Air Station North Island – سان دييغو


=== KO ===
KOAJ – Albert J. Ellis Airport – جاكسونفيل
KOAK – مطار أوكلاند الدولي – أوكلاند
KOAR – Marina Municipal Airport – مارينا
KOBE – Okeechobee County Airport – أوكيتشوبي
KOBI – Woodbine Municipal Airport – وودبين
KOCF – Ocala International Airport – أوكالا
KOCH (OCH) – Nacogdoches A.L. Mangham Jr. Regional Airport – ناكوغدوشس
KOCW – Washington–Warren Airport – واشنطن
KODO - Odessa-Schlemeyer Field - أوديسا
KODX – Evelyn Sharp Field – أورد
KOEL – Oakley Municipal Airport – أوكلي
KOFF – Offutt Air Force Base – أوماها
KOFK – Norfolk Regional Airport – نورفولك
KOFP – Hanover County Municipal Airport – ريتشموند / آشلاند
KOGA – Searle Field – وغالالا
KOGB – Orangeburg Municipal Airport – أورانجبورغ
KOGD – Ogden-Hinckley Airport – أوغدن
KOGS – Ogdensburg International Airport – أوغدينسبورغ
KOIC – Lt. Warren Eaton Airport – نورويتش
KOIN – Oberlin Municipal Airport – أوبرلين
KOJA - Thomas P. Stafford Airport - ويذرفورد
KOJC – Johnson County Executive Airport – أولاث
KOKB – Oceanside Municipal Airport – أوشينسايد
KOKC (OKC) – Will Rogers World Airport – أوكلاهوما سيتي
KOKK – Kokomo Municipal Airport – كوكومو
KOKM - Okmulgee Regional Airport - أوكمولغي
KOKS – Garden County Airport – أوشكوش
KOKV – Winchester Regional Airport – وينشستر
KOLD – Old Town Municipal Airport and Seaplane Base – أولد تاون
KOLE – Cattaraugus County-Olean Airport – أولين
KOLF – L. M. Clayton Airport – وولف بوينت
KOLM – Olympia Regional Airport – أولمبيا
KOLS (OLS) – Nogales International Airport – نوغاليس
KOLU – Columbus Municipal Airport – كولمبوس
KOLV – Olive Branch Airport – أوليف برانش
KOLZ – Oelwein Municipal Airport – أويلوين
KOMA – Eppley Field – أوماها
KOMH – Orange County Airport – أورانج
KOMK – Omak Airport – أوماك
KOMN – Ormond Beach Municipal Airport – أورموند بيتش
KONA – Winona Municipal Airport – وينونا
KONL – O'Neill Municipal Airport – أونيل
KONM (ONM) – Socorro Municipal Airport – سوكورو
KONO – Ontario Municipal Airport – أونتاريو
KONP – Newport Municipal Airport – نيوبورت
KONT – Ontario International Airport – أونتاريو
KONX – Currituck County Regional Airport – كوريتوك
KOPF – Miami-Opa Locka Executive Airport – أوبا لوكا
KOPL – St. Landry Parish Airport – أوبلوساس
KOQN – Brandywine Airport – West Chester، Pennsylvania
KOQU (OQU) – Quonset State Airport – نورث كينغستاون
KORB – Orr Regional Airport – أور
KORD – مطار أوهير الدولي – شيكاغو
KORE – Orange Municipal Airport – أورانج
KORF – Norfolk International Airport – نورفولك
KORG – Orange County Airport – أورانج
KORH – Worcester Regional Airport – ورسستر
KORL – Orlando Executive Airport – أورلاندو
KORS (ESD) – Orcas Island Airport – Eastsound، Washington
KOSC (OSC) – Oscoda-Wurtsmith Airport – أوسكودا
KOSH – Wittman Regional Airport – أوشكوش
KOSU (OSU) – Ohio State University Airport – كولومبوس
KOSX – Kosciusko-Attala County Airport – كوسيوسكو
KOTH – Southwest Oregon Regional Airport – نورث بيند
KOTM – Ottumwa Regional Airport – أوتوموا
KOUN – University of Oklahoma Westheimer Airport – نورمان
KOVE – Oroville Municipal Airport – أوروفيل
KOVS – Boscobel Airport – بوسكوبل
KOWB – Owensboro-Daviess County Regional Airport – أوينسبورو
KOWD – Norwood Memorial Airport – نوروود
KOWI – Ottawa Municipal Airport – أوتاوا
KOWK – Central Maine Airport of Norridgewock – Norridgewock، Maine
KOXB (OCE) – Ocean City Municipal Airport – أوشن سيتي
KOXC – Waterbury-Oxford Airport – أوكسفورد
KOXD – Miami University Airport – أوكسفورد
KOXR – Oxnard Airport – أوكسنارد
KOYM – St. Marys Municipal Airport – سانت ماريز
KOZA - Ozona Municipal Airport - أوزونا
KOZR (OZR) – Cairns Army Airfield – فور ركر / أوزارك
KOZS (OZS) – Camdenton Memorial Airport – كامدنتون
KOZW – Livingston County Spencer J. Hardy Airport – هويل


=== KP ===
KPAE (PAE) – مطار باين فيلد – إيفرت
KPAH (PAH) - Barkley Regional Airport - بادوكا
KPAM – Tyndall AFB – بنما سيتي
KPAN (PJB) – Payson Airport – بايسون
KPAO – Palo Alto Airport – بالو ألتو
KPBF – Grider Field – باين بلاف
KPBG (PBG) – Plattsburgh International Airport – بلاتسبورغ ، نيويورك
KPBI (PBI) – مطار بالم بيتش الدولي – ويست بالم بيتش
KPBX – Pike County Airport (Hatcher Field) – بايكسفيل
KPCM – Plant City Airport – بلانت سيتي
KPCU – Picayune-Pearl River County Airport – بيكايون
KPCW – Erie–Ottawa International Airport – بورت كلينتون
KPCZ – Waupaca Municipal Airport – واوباكا
KPDC – Prairie du Chien Municipal Airport – برايري دو شين
KPDK (PDK) – DeKalb-Peachtree Airport – أتلانتا
KPDT (PDT) – Eastern Oregon Regional Airport – بيندلينتون
KPDX (PDX) – مطار بورتلاند الدولي – بورتلاند
KPEO – Penn Yan Airport – بن يان
KPEQ (PEQ) - Pecos Municipal Airport - بيكوس
KPFC – Pacific City State Airport – باسيفيك
KPFN – Panama City-Bay County International Airport – بنما سيتي (أغلق في 2010)
KPGA (PGA) – Page Municipal Airport – بيج
KPGD (PGD) – Punta Gorda Airport – بونتا غوردا
KPGR – Kirk Field – باراغولد
KPGV (PGV) – Pitt-Greenville Airport – غرينفيل
KPHD – Harry Clever Field Airport – نيو فيلادلفيا، أوهايو
KPHF (PFH) – Newport News/Williamsburg International Airport – نيوبورت نيوز
KPHG – Phillipsburg Municipal Airport – فيليبسبورج
KPHH – Robert F. Swinnie Airport – اندروز
KPHK – Palm Beach County Glades Airport – باهوكي
KPHL (PHL) – مطار فيلادلفيا الدولي – فيلادلفيا
KPHP – Philip Airport – فيليب
KPHT – Henry County Airport – باريس
KPHX (PHX) – مطار فينيكس سكاي هاربر الدولي – فينيكس
KPIA (PIA) – General Wayne A. Downing Peoria International Airport – بيوريا
KPIB (PIB) – Hattiesburg-Laurel Regional Airport – هاتيسبورغ
KPIE (PIE) – St. Pete-Clearwater International Airport – سانت بيترسبرغ
KPIH (PIH) – Pocatello Regional Airport – بوكاتيلو
KPIR (PIR) – Pierre Regional Airport – بيير
KPIT (PIT) – Pittsburgh International Airport – بيتسبرغ
KPKB (PKB) – Mid-Ohio Valley Regional Airport – باركرسبورغ
KPKV (PKV) – Calhoun County Airport – بورت لافاكا
KPLB (PLB) – Clinton County Airport  – بلاتسبورغ (مغلق)
KPLK – M. Graham Clark Downtown Airport – Point Lookout، Missouri
KPLN (PLN) – Pellston Regional Airport – بيلستون
KPLR (PLR) – St. Clair County Airport – بيل سيتي
KPLU (PLU) - Pierce County Airport - غراهام
KPMB – Pembina Municipal Airport – بيمبينا
KPMD – Palmdale Regional Airport – بالمديل
KPMV (PMV) – Plattsmouth Municipal Airport – بلاتسموث
KPMZ (PMZ) – Plymouth Municipal Airport – بليموث
KPNA (PWY) – Ralph Wenz Field – باينديل
KPNC (PNC) - Ponca City Regional Airport - بونكا سيتي
KPNE (PNE) – Northeast Philadelphia Airport – فيلادلفيا
KPNM (PNM) – Princeton Municipal Airport – برينستون
KPNN (PNN) – Princeton Municipal Airport – Princeton، Maine
KPNS (PNS) – Pensacola International Airport – بينساكولا
KPOB – Pope Field (عسكري) – فايتفيل
KPOC – Brackett Field – لا فيرني
KPOU – Hudson Valley Regional Airport – بكبسي
KPOY – Powell Municipal Airport – باول
KPPA (PPA) – Perry LeFors Field – بامبا
KPPF – Tri-City Airport – بارسونز
KPQI (PQI) – Presque Isle International Airport – بريسكيو إزلي
KPQL (PGL) – Trent Lott International Airport – باسكاغولا
KPRB – Paso Robles Municipal Airport – باسو روبليس
KPRC (PRC) – Ernest A. Love Field – بريسكوت
KPRN – Mac Crenshaw Memorial Airport – غرينفيل
KPRX – Cox Field – باريس
KPSB – Mid-State Regional Airport – فيليبسبورغ سنتر مقاطعة
KPSC (PSC) – Tri-Cities Airport – باسكو
KPSF – Pittsfield Municipal Airport – بيتسفيلد
KPSK – New River Valley Airport – دوبلين
KPSM – Portsmouth International Airport at Pease – بورتسموث
KPSN (PSN) – Palestine Municipal Airport – فلسطين
KPSO – Stevens Field – باغوسا سبرينغز
KPSP (PSP) – Palm Springs International Airport – بالم سبرينغس
KPTB – Dinwiddie County Airport – بطرسبرغ
KPTD – Potsdam Municipal Airport – Potsdam، New York
KPTK (PTK) – Oakland County International Airport – ووترفورد
KPTN – Harry P. Williams Memorial Airport – باترسون
KPTS – Atkinson Municipal Airport – بيتسبرغ
KPTT (PTT) – Pratt Regional Airport – برات
KPTV (PTV) – Porterville Municipal Airport – بورتيرفيل
KPTW – Heritage Field – Pottstown، Pennsylvania
KPUB (PUB) – Pueblo Memorial Airport – بويبلو
KPUC – Carbon County Regional Airport – برايس
KPUJ – Silver Comet Field at Paulding Northwest Atlanta Airport – دالاس
KPUW (PUW) – Pullman-Moscow Regional Airport – بولمان
KPVB – Platteville Municipal Airport – بلاتفيل
KPVC – Provincetown Municipal Airport – Provincetown، Massachusetts
KPVD (PVD) – T.F. Green State Airport – بروفيدنس
KPVE – Beech River Regional Airport – Darden، Tennessee
KPVF – Placerville Airport – بليسرفيل
KPVG – Hampton Roads Executive Airport – تشيسابيك
KPVJ - Pauls Valley Municipal Airport - بولس فالي
KPVU (PVU) – Provo Municipal Airport – بروفو
KPVW (PVW) - Hale County Airport - بلينفيو
KPWA (PWA) - Wiley Post Airport - أوكلاهوما سيتي
KPWD – Sher-Wood Airport – بلينتيوود
KPWK (PWK) – Chicago Executive Airport – ويلينغ
KPWM (PWM) – Portland International Jetport – بورتلاند
KPWT (PWT) – Bremerton National Airport – بريميرتون
KPXE (PXE) – Perry-Houston County Airport – بيري
KPYG – Pageland Airport – باجيلاند
KPYM (PYM) – Plymouth Municipal Airport – بليموث
KPYP (PYP) – Centre-Piedmont-Cherokee County Regional Airport – سنتر
KPYX (PYX) – Perryton Ochiltree County Airport - بيريتون


=== KQ ===
(المواقع التي تديرها وزارة دفاع الولايات المتحدة))

KQA7 – ترين كوت، أفغانستان
KQAD – FOB Echo، الديوانية، العراق
KQAE – المسيب، العراق
KQAJ – قاعدة عين الأسد الجوية، العراق
KQAO – Hanau AAF، ألمانيا (مغلق في 2007)
KQAQ – معسكر التاجي، العراق
KQAX – معسكر النصر (مطار بغداد الدولي)، العراق
KQAY – Patton AAF، معسكر عريفجان، الكويت
KQCO – قاعدة القيارة الجوية، العراق
KQCT – الرمادي، العراق
KQCU – Fort Chaffee، آركنسا
KQD9 – FOB Salerno، خوست، أفغانستان
KQDM – Orgun، أفغانستان
KQEZ – قاعدة التقدم الجوية، العراق
KQGV – قاعدة علي السالم الجوية، الكويت
KQGX – قاعدة الظفرة الجوية، الإمارات العربية المتحدة
KQIR – قاعدة العديد الجوية، قطر
KQIU – Fire Base Lilley، Shkin، أفغانستان
KQL5 – جلال آباد، أفغانستان
KQMA – Camp Fallujah، العراق
KQMG – قاعدة طلحة الجوية، العراق
KQMH – الرطبة، العراق
KQNC – خليج سودا، اليونان
KQNN – نابولي، إيطاليا
KQNS – القاعدة البحرية الجوية في سيغونيلا، إيطاليا
KQNT – NAS Keflavik، Iceland
KQNY – الرمادي، العراق
KQOS – Oscura Range، New Mexico
KQPC – Camp Gannon (حصيبة)، العراق
KQPD – COP حديثة، العراق
KQRY – غزنة، أفغانستان
KQSA – قاعدة بغرام، أفغانستان
KQSE – الموصل، العراق
KQSL – قاعدة سبايكر الجوية، العراق
KQSM – قاعدة ميساوا الجوية، اليابان
KQSR – شرنه، أفغانستان
KQTA – NAF Atsugi، اليابان
KQTI – تلعفر، العراق
KQTO – قاعدة بلد الجوية، العراق
KQTU – FOB Marez (الموصل)، العراق
KQTX – مطار كركوك الدولي، العراق
KQTZ – مطار بغداد الدولي، العراق
KQVO – القائم، العراق
KQWM – معسكر بيوري، الكويت
KQXJ – قاعدة الإمام علي الجوية (الناصرية)، العراق
KQXN – النجف، العراق
KQYB – Faurei، رومانيا


=== KR ===
KRAC (RAC) – John H. Batten Airport – راسين
KRAL – Riverside Municipal Airport – ريفرسايد
KRAP (RAP) – Rapid City Regional Airport – رابيد سيتي
KRAW (RAW) – Warsaw Municipal Airport – وارسو
KRBD (RBD) – Dallas Executive Airport – دالاس
KRBE – Rock County Airport – باسيت
KRBG (RBG) – Roseburg Regional Airport – روزبيرغ
KRBL – Red Bluff Municipal Airport – ريد بلوف
KRBM – Robinson Army Airfield – Camp Robinson، أركنساس
KRBW (RBW) – Lowcountry Regional Airport – والتربورو
KRCA – Ellsworth Air Force Base – رابيد سيتي
KRCE (RCE) - Clarence E. Page Municipal Airport - أوكلاهوما سيتي
KRCM – SkyHaven Airport – وارنسبورغ
KRCT (RCT) – Nartron Field – ريد سيتي
KRDD (RDD) – Redding Municipal Airport – ردينغ
KRDG (RDG) – Reading Regional Airport – ريدينغ
KRDM (RDM) – Roberts Field – ريدموند
KRDR – Grand Forks Air Force Base – غراند فوركس
KRDU (RDU) – Raleigh-Durham International Airport – رالي
KRED – Red Lodge Airport – ريد لودج
KREG – Louisiana Regional Airport – غونزاليس
KREI – Redlands Municipal Airport – ريدلاندس
KREO – Rome State Airport – Rome، Oregon
KRFD (RFD) – مطار شيكاغو روكفورد الدولي – روكفورد
KRGK – Red Wing Regional Airport – ريد وينغ
KRHI (RHI) – Rhinelander-Oneida County Airport – رينلاندر
KRHP – Western Carolina Regional Airport – اندروز
KRHV – Reid-Hillview Airport of Santa Clara County – سان خوسيه
KRIC (RIC) – Richmond International Airport – Sandston، Virginia
KRID – Richmond Municipal Airport – ريتشموند
KRIF – ريتشفيلد – ريتشفيلد
KRIL (RIL) – Garfield County Regional Airport – ريفل
KRIR – Flabob Airport – ريفرسايد
KRIU – Rancho Murieta Airport – Rancho Murieta، California
KRIV – March Air Reserve Base – ريفرسايد
KRIW (RIW) – Central Wyoming Regional Airport – ريفرتون
KRJD – Ridgely Airpark – ريدجلي
KRKR - Robert S. Kerr Airport - بوتو
KRKD (RKD) – Knox County Regional Airport – روكلاند
KRKS (RKS) – Southwest Wyoming Regional Airport – روك سبرينغز
KRLD – Richland Airport – ريتشلاند
KRME (RME) – Griffiss International Airport – رومي
KRMN – Stafford Regional Airport – Stafford، Virginia
KRND – Randolph Air Force Base – سان أنطونيو
KRNM – Ramona Airport – رامونا
KRNO (RNO) – مطار رينو تاهو الدولي – رينو
KRNT (RNT) – Renton Municipal Airport – رينتون
KRNV – Cleveland Municipal Airport – كليفلاند
KROA (ROA) – Roanoke-Blacksburg Regional Airport – روانوك
KROC (ROC) – Greater Rochester International Airport – روتشستر
KROG – Rogers Executive Airport – روجرز
KROW (ROW) – Roswell International Air Center – روزويل
KRPB – Belleville Municipal Airport – بلفيل
KRPD – Rice Lake Regional Airport – رايز ليك
KRPH – غراهام – غراهام
KRPX – Roundup Airport – راوندأب
KRQE – Window Rock Airport – ويندو روك
KRRT (RRT) – Warroad International Memorial Airport – وورود
KRSL – Russell Municipal Airport – روسيل
KRST (RST) – Rochester International Airport – روشستر
KRSW (RSW) – Southwest Florida International Airport – فورت مايرز
KRTN (RTN) – Raton Municipal Airport/Crews Field – راتون
KRTS - Reno Stead Airport - رينو
KRUE – Russellville Regional Airport – راسلفيل
KRUG – Rugby Municipal Airport – رغبي
KRUQ (SRW) – Mid-Carolina Regional Airport – ساليسبري
KRUT (RUT) – Rutland-Southern Vermont Regional Airport – روتلاند
KRVL – Mifflin County Airport – ريدسفيل
KRVS (RVS) – Richard Lloyd Jones Jr. Airport – تلسا
KRWI – Rocky Mount-Wilson Regional Airport – روكي ماونت
KRWL – Rawlins Municipal Airport – رولينز
KRWV – Caldwell Municipal Airport – كالدويل
KRXE – Rexburg-Madison County Airport – ريكسبورغ
KRYN – Ryan Field – توسان
KRYV – Watertown Municipal Airport – ووترتاون
KRYW – Lago Vista TX-Rusty Allen Airport – لاغو فيستا
KRYY – Cobb County International-McCollum Field Airport – كينيساو
KRZL – Jasper County Airport – رينسيلار
KRZN – Burnett County Airport – سيرن
KRZT – Ross County Airport – تشيليكوث
KRZZ – Halifax County Airport – رونوك رابيدز


=== KS ===
KSAA – Shively Airport – ساراتوغا
KSAC – Sacramento Executive Airport – ساكرامنتو
KSAD (SAD) – Safford Regional Airport – سافورد
KSAF (SAF) – Santa Fe Regional Airport – سانتا فيه
KSAN (SAN) – مطار سان دييغو الدولي – سان دييغو
KSAS – Salton Sea Airport – سالتون
KSAT (SAT) – مطار سان أنطونيو الدولي – سان أنطونيو
KSAV (SAV) – Savannah/Hilton Head International Airport – سافانا
KSAW (MQT) - Sawyer International Airport – ماركيت
KSAZ – Staples Municipal Airport – ستابليس
KSBA (SBA) – Santa Barbara Municipal Airport – سانتا باربارا
KSBD (SBD) – San Bernardino International Airport – سان برناردينو
KSBM (SBM) – Sheboygan County Memorial Airport – شيبويغن
KSBN (SBN) – South Bend International Airport – ساوث بند
KSBO – East Georgia Regional Airport – سوينسبورغ
KSBP – San Luis Obispo County Regional Airport – سان لويس أوبيسبو
KSBS (SBS) – Steamboat Springs Airport – ستيمبوت سبرينغز
KSBX – Shelby Airport – شيلبي
KSBY (SBY) – Salisbury-Ocean City Wicomico Regional Airport – سالزبوري
KSCB – Scribner State Airport – سكريبنير
KSCD – Sylacauga Municipal Airport – سيلاكاوغا
KSCH – Schenectady County Airport – سكنيكتادي
KSCK (SCK) – Stockton Metropolitan Airport – ستوكتون
KSCR – Siler City Municipal Airport – سيلير
KSDC – Williamson-Sodus Airport – Williamson/Sodus، New York
KSDF (SDF) – Louisville International Airport – لويفيل
KSDL (SCF) – Scottsdale Airport – سكوتسديل
KSDM – Brown Field Municipal Airport – سان دييغو
KSDY – Sidney-Richland Municipal Airport – سيدني
KSEA (SEA) – مطار سياتل تاكوما الدولي – سياتل
KSEE – Gillespie Field – سان دييغو
KSEF (SEF) – Sebring Regional Airport – سيبرينغ
KSEG (SEG) – Penn Valley Airport – سيلينسغروف
KSEM (SEM) – Craig Field – سلما
KSEP – Stephenville Clark Regional Airport – ستيفنفيل
KSEZ (SDX) – Sedona Airport – سيدونا
KSFB (SFB) – مطار اورلاندو سانفورد الدولي – سانفورد
KSFD – Winner Regional Airport (Bob Wiley Field) – وينر
KSFF (SFF) – Felts Field – سبوكين
KSFM – Sanford Seacoast Regional Airport – سانفورد
KSFO (SFO) – مطار سان فرانسيسكو الدولي – سان فرانسيسكو
KSFQ – Suffolk Executive Airport – سوفولك
KSFZ – North Central State Airport – بوتكيت
KSGF (SGF) – Springfield-Branson National Airport – سبرينغفيلد
KSGJ – Northeast Florida Regional Airport – سانت أوغسطين
KSGT (SGT) – Stuttgart Municipal Airport – شتوتغارت
KSGU – St. George Municipal Airport – سانت جورج (أغلق في 2011)
KSGU (SGU) – St. George Regional Airport – سانت جورج
KSHD (SHD) – Shenandoah Valley Regional Airport – ستونتون
KSHN – Sanderson Field – شيلتون
KSHR (SHR) – Sheridan County Airport – شيريدان
KSHV (SHV) – Shreveport Regional Airport – شريفبورت
KSIF – Rockingham County NC Shiloh Airport – ستونفيل
KSIK (SIK) – Sikeston Memorial Municipal Airport – سيكستون، ميزوري
KSIY (SIY) – Siskiyou County Airport – مونتاغوي
KSJC (SJC) – مطار سان خوسيه الدولي – سان خوسيه
KSJN (SJN) – St. Johns Industrial Air Park – سانت جونز
KSJT (SJT) – San Angelo Regional Airport – سان أنجيلو
KSKA – Fairchild Air Force Base – سبوكين
KSKF – Kelly Field Annex – سان أنطونيو
KSKI – Sac City Municipal Airport – ساك سيتي
KSKX – Taos Regional Airport – تاوس
KSLB – Storm Lake Municipal Airport – ستورم ليك
KSLC (SLC) – مطار سولت ليك سيتي الدولي – سولت ليك
KSLE (SLE) – McNary Field – سايلم
KSLG (SLG) – Smith Field – سايلوم سبرينغز
KSLI – Los Alamitos Army Airfield – لوس ألاميتوس
KSLK (SLK) – Adirondack Regional Airport – سارانك ليك
KSLN (SLN) – Salina Regional Airport – سالينا
KSLR – Sulphur Springs Municipal Airport – سولفر سبرينغز
KSMD (SMD) – Smith Field – فورت واين
KSME – Lake Cumberland Regional Airport – سومرست
KSMF(SMF) – Sacramento International Airport – ساكرامنتو
KSMN – Lemhi County Airport – سالمون
KSMO (SMO) – Santa Monica Airport – سانتا مونيكا
KSMQ – Somerset Airport – سومرفيل
KSMS – Sumter Airport – سمتر
KSMX (SMX) – Santa Maria Public Airport – سانتا ماريا
KSNA (SNA) – John Wayne Airport – سانتا آنا
KSNC – Chester Airport – تشيستر
KSNK - Winston Field - سنايدر
KSNL (SNL) – Shawnee Regional Airport – شوني
KSNS (SNS) – Salinas Municipal Airport – ساليناس
KSNT - Stanley Airport - ستانلي
KSNY (SNY) – Sidney Municipal Airport – سيدني
KSOA (SOA) - Sonora Municipal Airport - سونورا
KSOP (SOP) – Moore County Airport – ويسبرينغ بينس
KSOW (SOW) – Show Low Regional Airport – شو لو
KSPA (SPA) – Spartanburg Downtown Memorial Airport – سبارتانبرغ
KSPB – Scappoose Industrial Airpark – سكابوس
KSPD – Springfield Municipal Airport – سبرينغفيلد
KSPF – Black Hills Airport – سبيرفيش
KSPG – Albert Whitted Airport – سانت بيترسبرغ
KSPH - Springhill Airport - سبرينغهيل
KSPI (SPI) - Abraham Lincoln Capital Airport - سبرينغفيلد
KSPS (SPS) – Wichita Falls Regional Airport / Sheppard Air Force Base – ويتشيتا فولز
KSPW (SPW) – Spencer Municipal Airport – سبنسر
KSPX – مطار خليج هيوستن – ليغ سيتي (أغلق في 2002)
KSPZ - Silver Springs Airport - سيلفر سبرينغز
KSQL (SQL) – San Carlos Airport – سان كارلوس
KSRC – Searcy Municipal Airport – سيرسي
KSRQ (SRQ) – Sarasota-Bradenton International Airport – ساراسوتا
KSRR (RUI) – Sierra Blanca Regional Airport – رويدوسو
KSSC – Shaw Air Force Base – سمتر
KSSF (SSF) – Stinson Municipal Airport – سان أنطونيو
KSSI (SSI) – McKinnon St. Simons Island Airport – برونزويك
KSSN – Seneca Army Airfield – Romulus، New York
KSSQ – Shell Lake Municipal Airport – شيل ليك
KSTC – St. Cloud Regional Airport – سانت كلاود
KSTF – George M. Bryan Airport – ستاركفيل
KSTK – Sterling Municipal Airport – سترلينغ
KSTL (STL) – مطار سانت لويس الدولي – سانت لويس
KSTP (STP) – St. Paul Downtown Airport – سانت بول
KSTS (STS) – Charles M. Schulz-Sonoma County Airport – سانتا روسا
KSUA – Witham Field – ستيوارت
KSUN (SUN) – Friedman Memorial Airport – هايلي
KSUS – Spirit of St. Louis Airport – سانت لويس
KSUT – Cape Fear Regional Jetport – أوك أيلاند
KSUU – Travis Air Force Base – فيرفيلد
KSUW – Richard I. Bong Airport – سوبريور
KSUX (SUX) – مطار سيوكس سيتي – سيوكس سيتي
KSUZ – Saline County Regional Airport – بنتون
KSVC (SVC) – Grant County Airport – سيلفر سيتي
KSVE – Susanville Municipal Airport – سوسانفيلي
KSVH – Statesville Regional Airport – ستيتسفيل
KSWF (SWF) – Stewart International Airport – نيو ويندسور
KSWI – Sherman Municipal Airport – شيرمان
KSWO (SWO) - Stillwater Regional Airport - ستيلووتر
KSWT – Seward Municipal Airport – سيوارد
KSWW (SWW) – Avenger Field – سويتواتر
KSXL – Summersville Airport – سمرسفيل
KSXT - Sexton Summit Weather Station - غرانتس باس
KSXU – Santa Rosa Route 66 Airport – سانتا روزا
KSYF – Cheyenne County Municipal Airport – سانت فرنسيس
KSYI – Shelbyville Municipal Airport – شيلبيفيل
KSYL – Roberts Army Heliport – Camp Roberts، مقاطعة سان لويس أوبيسبو
KSYN (SYN) – Stanton Airfield – Stanton، Minnesota
KSYR (SYR) – Syracuse Hancock International Airport – سيراكيوز
KSZL – Whiteman Air Force Base – مقاطعة جونسون
KSZP – Santa Paula Airport – سانتا باولا
KSZT – Sandpoint Airport – ساندبوينت


=== KT ===
KTAD – Perry Stokes Airport – ترينيداد
KTAN – Taunton Municipal Airport – تونتون
KTBN (TBN) – Waynesville-St. Robert Regional Airport – Fort Leonard Wood، Missouri
KTBR (TBR) – Statesboro–Bulloch County Airport – ستايتسبورو
KTBX – Shoshoni Municipal Airport – شوشوني
KTCC – Tucumcari Municipal Airport – توكومكاري
KTCL (TCL) – Tuscaloosa Regional Airport – توسكالوسا
KTCM – McChord Air Force Base – تاكوما
KTCS – Truth or Consequences Municipal Airport – تروث أور كونسكيونسيس
KTCY – Tracy Municipal Airport – تراساي
KTDF – Person County Airport – روكسبورو
KTDO – Toledo-Winston Carlock Memorial Airport – توليدو
KTDW – Tradewind Airport – أماريلو
KTEB (TEB) – Teterboro Airport – Teterboro، New Jersey
KTEL – Perry County Municipal Airport – تل سيتي
KTEX (TEX) – Telluride Regional Airport – تيلورايد
KTGI – Tangier Island Airport – تانغير
KTHM – Thompson Falls Airport – تومسون فولز
KTHP – Hot Springs County Municipal Airport – ثيرموبوليس
KTHV (THV) – York Airport – يورك
KTIK – Tinker Air Force Base – أوكلاهوما سيتي
KTIW (TIW) – Tacoma Narrows Airport – تاكوما
KTIX (TIX) – Space Coast Regional Airport – تيتوسفيل
KTKI (TKI) – McKinney National Airport – ماككيني
KTKO – Mankato Airport – مانكيتو
KTKV (TKV) – Tomahawk Regional Airport – توماهوك
KTLH (TLH) – Tallahassee International Airport – تالاهاسي
KTLR (TLR) – Mefford Airport – تولاري
KTMB (TMB) – Kendall-Tamiami Executive Airport – ميامي
KTME – Houston Executive Airport – مقاطعة والر
KTMK (OTK) - Tillamook Airport - تيلاموك
KTNP (TNP) – Twentynine Palms Airport – توينتينين بالمس
KTNT (TNT) – Dade-Collier Training and Transition Airport – ميامي
KTNU – Newton Municipal Airport – نيوتن
KTNX (XSD) – Tonopah Test Range Airport – تونوباه
KTOA (TOA) – زامبيريني فيلد – توررانسي
KTOI (TOI) – Troy Municipal Airport – تروي
KTOL (TOL) – Toledo Express Airport – توليدو
KTOP – Billard Municipal Airport – توبيكا
KTOR – Torrington Municipal Airport – تورينغتون
KTPA (TPA) – مطار تامبا الدولي – تامبا
KTPF (TPF) – Peter O. Knight Airport – Davis Island، تامبا
KTPH – Tonopah Airport – تونوباه
KTPL (TPL) – Draughon-Miller Central Texas Regional Airport – تمبل
KTQE – Tekamah Airport – تيكاماه
KTQH - Tahlequah Municipal Airport - تاهليكوا
KTQK – Scott City Municipal Airport – Scott City، Nebraska
KTRI (TRI) – Tri-Cities Regional Airport – بلونتفيل
KTRK (TKF) – Truckee Tahoe Airport – تروكي
KTRM (TRM) – Jacqueline Cochran Regional Airport – Thermal، California
KTRX – Trenton Municipal Airport – ترينتون
KTSP – Tehachapi Municipal Airport – تيهاتشابي
KTTA (TTA) – Raleigh Executive Jetport – سانفورد
KTTD (TTD) – Portland-Troutdale Airport – بورتلاند
KTTF – Custer Airport – مونرو
KTTN (TTN) – Trenton-Mercer Airport – ترنتون
KTUL (TUL)  – Tulsa International Airport – تلسا
KTUP (TUP) – Tupelo Regional Airport – توبيلو
KTUS (TUS) – مطار توسان الدولي – توسان
KTVC (TVC) – Cherry Capital Airport – ترافيرس سيتي
KTVF (TVF) – Thief River Falls Regional Airport – ثيف ريفر فولز
KTVL – Lake Tahoe Airport – سووث لاك تاهوي
KTVR (TVR) – Vicksburg – Tallulah Regional Airport – تالولاه
KTVY – Tooele Valley Airport – تويلي
KTVZ - Tompkinsville Monroe County Airport - تومبكينسفيل
KTWF (TWF) – Magic Valley Regional Airport – توين فولز
KTWT – Sturgis Municipal Airport – ستورغيس
KTXK (TXK) – Texarkana Regional Airport – تيكساركانا
KTXW – Mid Valley Airport – ويسلاكو
KTYL (TYZ) – Taylor Airport – تايلور
KTYQ – Indianapolis Executive Airport – إنديانابوليس
KTYR (TYR) – Tyler Pounds Regional Airport – تايلر
KTYS (TYS) – McGhee Tyson Airport – نوكسفيل
KTZR – Bolton Field – كولومبوس
KTZT – Belle Plaine Municipal Airport – بيلي بلين


=== KU ===
KUAO – Aurora State Airport – أورورا
KUBE – Cumberland Municipal Airport – كمبرلاند
KUBS – Columbus-Lowndes County Airport – كولومبوس
KUCA – Oneida County Airport – أوتيكا
KUCP – New Castle Municipal Airport – نيو كاسل
KUDD – Bermuda Dunes Airport – بالم سبرينغس
KUDG – Darlington County Jetport – داريلنغتون
KUES – Waukesha County Airport – وكيشا
KUGN – Waukegan National Airport – وكغن
KUIL – Quillayute Airport – Quillayute، Washington
KUIN – Quincy Regional Airport – كوينسي
KUKF – Wilkes County Airport – نورث ويلكيسبورو
KUKI – Ukiah Municipal Airport – وكياه
KUKL – Coffey County Airport – برلنغتون
KUKT – Quakertown Airport – كويكرتاون
KULS – Ulysses Airport – يوليسيس
KUMP – Indianapolis Metropolitan Airport – فيشرز
KUNI (ATO) – Gordon K. Bush Airport – أثينس / ألباني
KUNU (UNU) – Dodge County Airport – جونو
KUNV (SCE) – University Park Airport – University Park، Pennsylvania
KUOS (UOS) – Franklin County Airport – سواني
KUOX (UOX) – University-Oxford Airport – أكسفورد
KUTA (UTM) – Tunica Municipal Airport – تونيكا
KUTS (HTV) – Huntsville Municipal Airport – هانتسفيل
KUUU – Newport State Airport – نيوبورت
KUVA (UVA) – Garner Field – أفايلد
KUZA – Rock Hill/York County Airport – روك هيل


=== KV ===
KVAY – South Jersey Regional Airport – Mount Holly، New Jersey
KVBG – قاعدة فاندنبرغ الجوية – لومبوك
KVBT – Bentonville Municipal Airport – بنتونفيل
KVBW – Bridgewater Airport – بريدجواتر
KVCB – Nut Tree Airport – فاكافيلي
KVCT (VCT) – Victoria Regional Airport – فيكتوريا
KVCV (VCV) – Southern California Logistics Airport – فيكتورفيل
KVDF – Tampa Executive Airport – تامبا
KVEL (VEL) – Vernal Regional Airport – فيرنال
KVER – Jesse Viertel Memorial Airport – بونفيل
KVES – Darke County Airport – فارسايليس
KVGT (VGT) – North Las Vegas Airport – لاس فيغاس
KVIH (VIH) – Rolla National Airport – رولا / فايتشي
KVIS (VIS) – Visalia Municipal Airport – فيساليا
KVJI – Virginia Highlands Airport – أبينغدون
KVKS – Vicksburg Municipal Airport – فيكسبيرغ
KVKX – Potomac Airfield – فريندلي
KVLD (VLD) – Valdosta Regional Airport – فالدوستا
KVLL – Oakland-Troy Airport – تروي
KVMR – Davidson Airport – فيرمليون
KVNC (VNC) – Venice Municipal Airport – فينيس، فلوريدا
KVNY (VNY) – مطار فان نويز – فان نويس
KVPS (VPS) – Destin-Fort Walton Beach Airport / Eglin Air Force Base – Valparaiso، Florida
KVPZ – Porter County Regional Airport – فالبارايسو
KVQQ (VQQ) – Cecil Airport – جاكسونفيل
KVRB (VRB) – Vero Beach Regional Airport – Vero Beach، Florida
KVSF (VSF) – Hartness State Airport – سبرينغفيلد
KVTA – Newark-Heath Airport – نيوارك
KVTN – Miller Field – فاليتين
KVUJ – Stanly County Airport – ألبيمارل
KVUO – Pearson Field – فانكوفر
KVVS – Joseph A. Hardy Connellsville Airport – كونيلسفيل
KVYS – Illinois Valley Regional Airport – بيرو


=== KW ===
KWAL – Wallops Flight Facility – Wallops Island، فرجينيا
KWAY – Greene County Airport – واينسبرغ
KWBW (WBW) – Wilkes-Barre Wyoming Valley Airport – ويلكس بار
KWDG (WDG) - Woodring Airport - إنيد
KWHP – Whiteman Airport – لوس أنجلوس
KWJF (WJF) – General William J. Fox Airfield – لانكستر
KWLD (WLD) – Strother Field – وينفيلد
KWLW (WLW) – Willows-Glenn County Airport – ويلاوس
KWMC (WMC) – Winnemucca Municipal Airport – وينيموكا
KWRB – Robins Air Force Base – وارنر روبينز، جورجيا
KWRI – McGuire Air Force Base – ريتستاون
KWRL – Worland Municipal Airport – ورلاند
KWST (WST) – Westerly State Airport – ويسترلي
KWVI (WVI) – Watsonville Municipal Airport – واتسونفيل
KWVL – Waterville Robert LaFleur Airport – ووترفيل
KWWD – Cape May Airport – وايلدوود
KWWR (WWR) - West Woodward Airport - وودوارد
KWYS (WYS) – Yellowstone Airport – ويست يلوستون


=== KX ===
KXBP – Bridgeport Municipal Airport – بريدجبورت
KXFL – Flagler County Airport – بانيل
KXLL – Allentown Queen City Municipal Airport – ألينتاون
KXMR – قاعدة كيب كانافيرال للقوات الجوية – كوكاو بيتش
KXNA (XNA) – Northwest Arkansas Regional Airport – هايفيل
KXNO – North Air Force Auxiliary Field – نورث
KXNX – Sumner County Regional Airport – غالاتين
KXTA (XTA) – المنطقة 51 – المنطقة 51
KXVG – Longville Municipal Airport – لونغفيل
KXWA (XWA) - Williston Basin International Airport - ويليستون


=== KY ===
KYIP (YIP) – مطار ويلو رن – يبسيلانتي
KYKM (YKM) – Yakima Air Terminal – ياكيما
KYKN (YKN) – Chan Gurney Municipal Airport – ينكتون
KYNG (YNG) – Youngstown-Warren Regional Airport – يونغزتاون / وارن


=== KZ ===
KZEF – Elkin Municipal Airport – ألكين
KZER – Schuylkill County Airport – بوتسفيل
KZPH (ZPH) – Zephyrhills Municipal Airport – زيفيرهيلز
KZUN – Black Rock Airport – زوني بويبلو (أغلق في 2018)
KZZV (ZZV) – Zanesville Municipal Airport – زانيسفيل


== المراجع ==


== وصلات خارجية ==
Meteorological station lookup at the National Weather Service
بوابة طيران