revision: 7502526
title: Zoznam miest vo svete
url: https://sk.wikipedia.org/wiki/Zoznam_miest_vo_svete


---

Toto je zoznam miest štátov, krajín, monarchií, provincií vo svete.


== A ==
 Zoznam miest v Afganistane - Afganistan
  Zoznam miest v Albánsku - Albánsko
  Zoznam miest v Alžírsku - Alžírsko
Anglicko - pozri Spojené kráľovstvo
  Zoznam miest na Amerických Panenských ostrovoch - Americké Panenské ostrovy (teritórium USA)
  Zoznam miest v Argentíne - Argentína
  Zoznam miest v Arménsku - Arménsko
  Zoznam miest v Austrálii - Austrália


== B ==
  Zoznam miest na Bahamách - Bahamy
  Zoznam miest v Bahrajne - Bahrajn
  Zoznam miest v Belgicku - Belgicko
  Zoznam miest v Belize - Belize
  Zoznam miest v Benine - Benin
  Zoznam miest v Bhutáne - Bhután
  Zoznam miest v Bielorusku - Bielorusko
  Zoznam miest v Bolívii - Bolívia
  Zoznam miest v Bosne a Hercegovine - Bosna a Hercegovina
  Zoznam miest v Botswane - Botswana
  Zoznam miest v Brazílii - Brazília
  Zoznam miest v Bruneji - Brunej
  Zoznam miest v Bulharsku - Bulharsko
  Zoznam miest v Burkina Faso - Burkina
  Zoznam miest v Burundi - Burundi


== C, Č ==
  Zoznam miest na Cypre - Cyprus
  Zoznam miest v Čade - Čad
  Zoznam miest v Česku - Česko
  Zoznam miest v Čiernej Hore - Čierna Hora
  Zoznam miest v Čile - Čile
  Zoznam miest v Číne - Čína


== D ==
  Zoznam miest v Dánsku - Dánsko
  Zoznam miest v Dominike - Dominika
  Zoznam miest v Dominikánskej republike - Dominikánska republika
  Zoznam miest v Džibutsku - Džibutsko


== E ==
  Zoznam miest v Egypte - Egypt
  Zoznam miest v Ekvádore - Ekvádor
  Zoznam miest v Eritrei - Eritrea
  Zoznam miest v Estónsku - Estónsko
  Zoznam miest v Etiópii - Etiópia


== F ==
  Zoznam miest na Faerských ostrovoch - Faerské ostrovy
  Zoznam miest vo Fidži - Fidži
  Zoznam miest na Filipínach - Filipíny
  Zoznam miest vo Fínsku - Fínsko
  Zoznam miest vo Francúzsku - Francúzsko
  Zoznam miest vo Francúzskej Guyane - Francúzska Guyana (francúzske teritórium)
  Zoznam miest vo Francúzskej Polynézii - Francúzska Polynézia (francúzske teritórium)


== G ==
  Zoznam miest v Gabone - Gabon
  Zoznam miest v Gambii - Gambia
  Zoznam miest v Gruzínsku - Gruzínsko
  Zoznam miest v Ghane - Ghana
  Zoznam miest v Gibraltári - Gibraltár
  Zoznam miest v Grécku - Grécko
  Zoznam miest v Grónsku - Grónsko
  Zoznam miest v Grenade - Grenada
  Zoznam miest v Guadeloupe - Guadeloupe (francúzske teritórium)
  Zoznam miest na Guame - Guam (teritórium USA)
  Zoznam miest v Guatemale - Guatemala
  Zoznam miest v Guinei - Guinea
  Zoznam miest v Guinei-Bissau - Guinea-Bissau
  Zoznam miest v Guyane - Guyana


== H ==
  Zoznam miest v Haiti - Haiti
  Zoznam miest v Holandsku - Holandsko
  Zoznam miest v Holandských Antilách - Holandské Antily (holandská autonómna časť)
  Zoznam miest v Hondurase - Honduras
  Zoznam miest v Hongkongu - Hongkong (čínska administratívna oblasť)


== CH ==
  Zoznam miest v Chorvátsku - Chorvátsko


== I ==
  Zoznam miest na Islande - Island
  Zoznam miest v Indii - India
  Zoznam miest v Indonézii - Indonézia
  Zoznam miest v Iráne - Irán
  Zoznam miest v Iraku - Irak
  Zoznam miest v Írsku - Írsko
  Zoznam miest v Izraeli - Izrael


== J ==
  Zoznam miest v Jamajke - Jamajka
  Zoznam miest v Japonsku - Japonsko
  Zoznam miest v Jemene - Jemen
  Zoznam miest v Jordánsku - Jordánsko
  Zoznam miest v Južnej Afrike - Južná Afrika - JAR
Južná Kórea pozri Kórejská republika
  Zoznam miest v Južnom Sudáne - Južný Sudán


== K ==
  Zoznam miest na Kajmaních ostrovoch - Kajmanie ostrovy (teritótium UK)
  Zoznam miest v Kambodži - Kambodža
  Zoznam miest v Kamerune - Kamerun
  Zoznam miest v Kanade - Kanada
  Zoznam miest na Kapverdách - Kapverdy
  Zoznam miest v Katare - Katar
  Zoznam miest v Kazachstane - Kazachstan
  Zoznam miest v Keni - Keňa
  Zoznam miest v Kiribati - Kiribati
  Zoznam miest v Kirgizsku - Kirgizsko
  Zoznam miest v Kolumbii - Kolumbia
  Zoznam miest na Komorách - Komory
  Zoznam miest v Kongu - Kongo (angl. Republic of the Congo)
  Zoznam miest v Konžskej demokratickej republike - Konžská demokratická republika (angl. Democratic Republic of the Congo)
  Zoznam miest v Južnej Kórei - Kórejská republika
  Zoznam miest v Severnej Kórei - KĽDR
  Zoznam miest v Kostarike - Kostarika
  Zoznam miest na Kube - Kuba
  Zoznam miest v Kuvajte - Kuvajt


== L ==
  Zoznam miest v Laose - Laos
  Zoznam miest v Lesothe - Lesotho
  Zoznam miest v Libanone - Libanon
  Zoznam miest v Libérii - Libéria
  Zoznam miest v Líbyi - Líbya
  Zoznam miest v Lichtenštajnsku - Lichtenštajnsko
  Zoznam miest v Litve - Litva
  Zoznam miest v Lotyšsku - Lotyšsko
  Zoznam miest v Luxembursku - Luxembursko


== M ==
  Zoznam miest v Macau - Macao (čínska administratívna oblasť)
  Zoznam miest na Madagaskare - Madagaskar
  Zoznam miest v Maďarsku - Maďarsko
  Zoznam miest v Malawi - Malawi
  Zoznam miest v Malajzii - Malajzia
  Zoznam miest na Maldivách - Maldivy
  Zoznam miest v Mali - Mali
  Zoznam miest na Malte - Malta
  Zoznam miest na Marshallových ostrovoch - Marshallove ostrovy
  Zoznam miest v Mauritánii - Mauritánia
  Zoznam miest na Mauríciuse - Maurícius
  Zoznam miest v Mayotte - Mayotte (francúzske teritórium)
  Zoznam miest v Mexiku - Mexiko
  Zoznam miest v Mikronézii - Mikronézia
  Zoznam miest v Moldavsku - Moldavsko
  Zoznam miest v Monaku - Monako
  Zoznam miest v Mongolsku - Mongolsko
  Zoznam miest v Montserrate - Montserrat (teritórium UK)
  Zoznam miest v Maroku - Maroko
  Zoznam miest v Mozambiku - Mozambik
  Zoznam miest v Mjanmarsku - Mjanmarsko


== N ==
  Zoznam miest v Nemecku - Nemecko
  Zoznam miest v Náhorno-karabašskej republike - Náhorná karabašská republika
  Zoznam miest v Namíbii - Namíbia
  Zoznam miest na Nauru - Nauru
  Zoznam miest v Nepále - Nepál
  Zoznam miest v Novej Kaledónii - Nová Kaledónia (francúzske teritórium)
  Zoznam miest na Novom Zélande - Nový Zéland
  Zoznam miest v Nikarague - Nikaragua
  Zoznam miest v Nigeri - Niger
  Zoznam miest v Nigérii - Nigéria
  Zoznam miest na Niue - Niue (súčasť Nového Zélandu)
  Zoznam miest v Nórsku - Nórsko


== O ==
  Zoznam miest v Ománe - Omán


== P ==
  Zoznam miest v Pakistane - Pakistan
  Zoznam miest v Palaue - Palau
  Zoznam miest v Palestíne - Palestína
  Zoznam miest v Paname - Panama
  Zoznam miest v Papue-Novej Guinei - Papua-Nová Guinea
  Zoznam miest v Paraguaji - Paraguaj
  Zoznam miest v Peru - Peru
  Zoznam miest na Pitcairnových ostrovoch - Pitcairnove ostrovy (UK teritórium)
 Zoznam miest v Pobreží Slonoviny  - Pobrežie Slonoviny
  Zoznam miest v Poľsku - Poľsko
  Zoznam miest v Portugalsku - Portugalsko
  Zoznam miest v Portoriku - Portoriko


== R ==
  Zoznam miest v Rakúsku - Rakúsko
  Zoznam miest v Rovníkovej Guinei - Rovníková Guinea
  Zoznam miest v Rumunsku - Rumunsko
  Zoznam miest v Rusku - Rusko
  Zoznam miest v Rwande - Rwanda


== S, Š ==
  Zoznam miest na Saint Pierre a Miquelon Saint Pierre a Miquelon (francúzske teritórium)
  Zoznam miest v Salvádore - Salvádor
  Zoznam miest na Samoe - Samoa
  Zoznam miest v San Maríne - San Maríno
  Zoznam miest v Saudskej Arábii - Saudská Arábia
  Zoznam miest v Senegale - Senegal
Severná Kórea pozri Kórejská ľudovodemokratická republika - Severná Kórea
  Zoznam miest v Severnom Macedónsku - Severné Macedónsko
  Zoznam miest na Severných Mariánach - Severné Mariány
  Zoznam miest v Severocyperskej tureckej republike - Severocyperská turecká republika
  Zoznam miest na Seychelách - Seychely
  Zoznam miest v Singapure - Singapur
  Zoznam miest v Sierra Leone - Sierra Leone
  Zoznam miest na Slovensku - Slovensko
  Zoznam miest v Slovinsku - Slovinsko
  Zoznam miest v Somálsku - Somálsko
  Zoznam miest v Somalilande - Soomaaliland
  Zoznam miest v Spojených arabských emirátoch - Spojené arabské emiráty
  Zoznam miest v Spojenom kráľovstve - Spojené kráľovstvo (Veľká Británia)
  Zoznam miest v USA - Spojené štáty (USA)
  Zoznam miest v Srbsku - Srbsko
  Zoznam miest v Srí Lanke - Srí Lanka
  Zoznam miest v Stredoafrickej republike - Stredoafrická republika
  Zoznam miest v Sudáne - Sudán
  Zoznam miest v Suriname - Surinam
  Zoznam miest na Svätom Krištofovi a Nevise - Svätý Krištof a Nevis
  Zoznam miest na Svätej Lucii - Svätá Lucia
  Zoznam miest na Svätom Tomášovi a Princových ostrovoch - Svätý Tomáš a Princov ostrov
  Zoznam miest na Svätom Vincente a Grenadínoch - Svätý Vincent a Grenadíny
  Zoznam miest v Svazijsku - Svazijsko
  Zoznam miest v Sýrii - Sýria
  Zoznam miest na Šalamúnových ostrovoch - Šalamúnove ostrovy
  Zoznam miest vo Švajčiarsku - Švajčiarsko
  Zoznam miest vo Švédsku - Švédsko
  Zoznam miest v Španielsku - Španielsko


== T ==
  Zoznam miest na Taiwane - Taiwan
  Zoznam miest v Tadžikistane - Tadžikistan
  Zoznam miest v Taliansku - Taliansko
  Zoznam miest v Tanzánii - Tanzánia
  Zoznam miest v Thajsku - Thajsko
  Zoznam miest v Togu - Togo
  Zoznam miest na Tonge - Tonga
  Zoznam miest na Trinidade a Tobagu - Trinidad a Tobago
  Zoznam miest na Tristan da Cunha - Tristan da Cunha (UK teritórium)
  Zoznam miest v Tunisku - Tunisko
  Zoznam miest v Turecku - Turecko
  Zoznam miest v Turkménsku - Turkménsko
  Zoznam miest v Tuvalu - Tuvalu


== U ==
  Zoznam miest v Ugande - Uganda
  Zoznam miest na Ukrajine - Ukrajina
USA pozri Spojené štáty
  Zoznam miest v Uruguaji - Uruguaj
  Zoznam miest v Uzbekistane - Uzbekistan


== V ==
  Zoznam miest vo Vanuatu - Vanuatu
  Vatikán
  Zoznam miest vo Venezuele - Venezuela
  Zoznam miest vo Vietname - Vietnam
  Zoznam miest vo Východnom Timore - Východný Timor


== Z ==
  Zoznam miest v Zambii - Zambia
  Zoznam miest v Zimbabwe - Zimbabwe
  Zoznam miest v Západnej Sahare - Západná Sahara


== Pozri aj ==
Zoznam miest (rozlišovacia stránka)
Zoznam štátov a závislých území


== Externé odkazy ==
A Dynamic Map of the World Cities' Growth anglicky
2005 city population estimates for the world anglicky


== Zdroj ==
Tento článok je čiastočný alebo úplný preklad článku Cities of present-day nations and states na anglickej Wikipédii (číslo revízie nebolo určené).