revision: 7543120
title: "Chlapi nepla\u010D\xFA"
url: https://sk.wikipedia.org/wiki/Chlapi_nepla%C4%8D%C3%BA


---

Chlapi neplačú je slovenský rodinný seriál, ktorý začala vysielať TV Markíza od 26. augusta 2013. Bol vysielaný každý pracovný deň a počas posledných sérií každý pracovný deň okrem štvrtku. 20. decembra 2013 sa odvysielala celá 1. séria. 27. januára 2014 seriál pokračoval 2. sériou. Od 2. septembra 2014  seriál pokračoval 3. sériou. Od 1. januára 2015 sa vysielala 4. séria, ktorá bola zároveň poslednou sériou seriálu. Seriál sa skončil 11. júna 2015.


== Dej ==


== Obsadenie ==


=== Postavy - 1. séria ===
Dominika Kavaschová – Paula Lánska Hronská
Tomáš Maštalír – Michal Lánsky
Petra Vajdová – Nora Lánska Fajnorová
Alexander Bárta – Roman Pollner
Hana Gregorová – Oľga Pollnerová
Dušan Jamrich – Ján Pollner
Marcel Chlpík – Pavol Paľko Hronský
Timur Kramár – Sebastián Lánsky
Gabriela Dzuríková – Cecília Sobotová
Milan Bahúl – Vincent Polák
Elena Podzámska – Erika Jeleniaková
Lukáš Pišta – Ladislav Sobota
Zuzana Frenglová – Alžbeta Hronská
Mária Lechmanová – Linda Poláková
Júlia Ružička Horváthová – Beáta Pepúchová
Gregor Hološka – Rudolf Pepúch
Viera Pavlíková – Hilda Pollnerová
Romana Dang Van – Anna Anička
Vladimír Hajdu – Svetozár Malatinský
Jana Lieskovská – Tatiana Hurbanová
Pavol Plevčík – Jakub
Karin Haydu – Bibiana
Jakub Rybárik – Karol
Martin Meľo – Vojtech
Peter Makranský – Milan
Filip Kreutz – Milan Milanko
Peter Kadlečík – Matej "Macek"
Katarína Baranová – Ľubomíra Čitkajová
Juraj Ďurdiak – JUDr. Šátek
Igor Šebesta – Gejza Šebesta
Peter Trník – Peter Zorba
Róbert Halák – Šimon
Marián Labuda ml. – Mokráň
Michaela Szocsová – Anna Mária
Přemysl Boublík – Gabriel
Ivo Hlaváček – Július
Katarína Šafaříková – Klára Surgentová
Mária Breinerová – Mária Mackovičová


=== Nové postavy - 2. séria ===
Kamil Mikulčík – Viktor Novotný
Marek Ťapák – Boris Fajnor
Peter Cibula – Ondrej Fischer
Jozef Švoňavský – Henrietin otec
Erik Peťovský – Hansi
Michal Monček – Stanislav Fajnor
Martin Zatovič – Jevgenij
Andrea Martvoňová – Henrieta
Eva Landlová – Jolana Fajnorová


=== Nové postavy - 3. séria ===
Branislav Deák – Igor Wagner
František Kovár – Vladimír Krajčovič
Kristína Svarinská – Zuzana Vasilenková
Henrieta Kecerová – Gabriela Poláková
Alena Pajtinková – Miroslava Mirka
Anna Sakmárová – Katarína Katka Valalíková
Gabriela Dolná – biologická matka Renáty Važeckej
Daniela Gudabová – Valéria Čitkajová
Gabriela Škrabáková-Kreutz – Renáta Važecká


=== Nové postavy - 4. séria ===
Filip Tůma – Kristián Murín
Lukáš Frlajs – Juraj Važecký
Stanislav Staško – MUDr. Martin Žák
Juraj Predmerský – Mário Valalík
Ivan Šándor – Filip Jenča
Jana Pilzová – Andrea Valalíková
Jana Hubinská – Jana Moláková


== Série ==


== Referencie ==


== Zdroje ==
http://chlapineplacu.markiza.sk