revision: 48861325
title: "Beck \u2013 The Money Man"
url: https://sv.wikipedia.org/wiki/Beck_%E2%80%93_The_Money_Man


---

Beck – The Money Man är en svensk TV-film från 1998. Detta är den sjunde filmen i den första omgången med Peter Haber och Mikael Persbrandt i huvudrollerna.


== Handling ==
En homosexuell polis dubbelliv är betalt och ombesörjt av Becks ärkefiende, Gavling, en höjdare i Stockholms undre värld. I gengäld har den homosexuelle polisen i åratal försett honom med hemlig information från rikspolisens arkiv. När polisassistenten försöker göra sig fri från Gavlings grepp, hittar man honom plötsligt död i en park. Hans död blir startskottet för den sista duellen mellan Beck och Gavling. En duell där ingenting är heligt och det bara finns en vinnare. 


== Rollista ==
Peter Haber - Martin Beck
Mikael Persbrandt - Gunvald Larsson
Stina Rautelin - Lena Klingström
Per Morberg - Joakim Wersén
Ingvar Hirdwall - Grannen
Lennart Hjulström - Lennart Gavling
Rebecka Hemse - Inger Beck
Fredrik Ultvedt - Jens Loftegård
Lasse Lindroth - Peter
Michael Nyqvist - John Banck
Peter Hüttner - Oljelund
Bo Höglund - Servitören
Mia Benson - Åklagare Lindgren
Jan von Melen - Hasse Larsson
Bengt Braskered - Leonard
Stefan Larsson - Gavlings torped
Monica Edwardsson - Gunilla Enmark, modern
Jan Nyman - Nordmark
Mats Flink - Piss-Bosse, uteliggare
Jan Mybrand - Karlberg
Jörgen Düberg - Gavling som ung
Rikard Bergqvist - Knarkhandlare
Lars Engström - Nordmarks far
Björn Wahlberg - Bartender
Johan Wahlström - Gavlings advokat
Ulrika Hansson - Knarkhandlarens hustru som ung
Lamine Dieng - Torped 2


== Externa länkar ==

Beck – The Money Man på Internet Movie Database (engelska)
Beck – The Money Man på Svensk Filmdatabas