revision: 6383611
title: Izvorno hrvatsko
url: https://hr.wikipedia.org/wiki/Izvorno_hrvatsko


---

Izvorno hrvatsko je znak  koji dodjeljuje Hrvatska gospodarska komora proizvodima i uslugama na području Hrvatske koji svojim postojanjem imaju izrazitu vrijednost koja odiše izvornom hrvatskom tradicijom, a ti isti proizvodi i usluge su plod isključivo inovacija, istraživanja i razvoja hrvatskih poduzeća i ljudi.
Proizvodi i usluge koje su dobili znak Izvorno hrvatsko prošli su niz rigoroznih kontrola HGK i njihovog Centra za kvalitetu te Tehničke komisije koji su provjerili dokumentaciju, certifikate i ostale značajke proizvoda i usluga koje su zatražile da im se dodijeli znak Izvorno hrvatsko. Nakon što su prošli sve kontrole i testiranja Savjet HGK donosi odluku o uvrštavanju proizvoda ili usluge na listu nosioca znaka Izvorno hrvatsko.


== Popis proizvoda i usluga sa znakom "Izvorno hrvatsko" ==

Bajadera- desert, proizvodi Kraš d.d. Zagreb
Sumamed - antibiotik, proizvodi PLIVA
Vegeta- dodatak jelu, priozvodi Podravka Koprivnica
Stara Badel šljivovica- rakija, proizvodi Badel 1862. d.d.
Mliječni namaz Dukatela - mliječni proizvod, proizvodi Dukat Zagreb
Petrine pletilje-  ručni vezeni rad, Petra Commerce, Zagreb
Paprenjak- tradicionalni hrvatski kolač, Paprenjak, Zagreb
Hrvatsko svečano odijelo- proizvodi Modni atelier Gena, Trogir
Secosec - kodirana sigurnosna plomba sa zaštitnom kapom, proizvodi Shacko d.o.o., Split
Amarena premium - voćni sirup, proizvodi Maraska d.d., Zadar
Vez koprivničkog ivanca- suvenir, ručni vez Baština, Koprivnički Ivanec
Melem - zaštitna krema, proizvodi Neva d.o.o., Zagreb
Informacijski sustav održavanja - Mims ver.3 - programska podrška, proizvodi ININ d.o.o., Slavonski Brod
Paška čipka - ručni vez, Grad Pag - DPČ “Frane Budak”, Pag
Vinjak "Trenk"  - vinjak, proizvodi Zvečevo d.d., Požega
Aplikativni softver - gospodarenje proračunskim sredstvima ver. 4.0  - programska podrška, Infomare d.o.o., Split
Izvorni posedarski dalmatinski pršut  - proizvodi Pršutana d.o.o., Posedarje
Paški sir  - mliječni proizvod, proizvodi Sirena - Mala sirana d.o.o., Kolan, otok Pag
Dalmatinski šokol  - mesni proizvod, Pršutana d.o.o., Posedarje
Dokup mirovine  - izvorno hrvatska vrsta otpremnine,  Royal mirovinsko osiguranje d.d., Zagreb
Pekmez od šljiva  - proizvodi Podravka d.d. Koprivnica
Kolekcija Morčić  - obrada zlata, Zlatarna Križek, Velika Gorica
Sustav informatizacije poslovanja autoprijevoznika -S.i.p.a. Verzija 1.xxx  - programska podrška, Digital Point d.o.o., Rijeka
Bravo™ - poslovni informacijski sustav u prometu verzija 3.xxx  - programska podrška, Euro-tera d.o.o., Zagreb
Lepoglavska čipka  - ručni vez,  Zadruga Lepoglavske čipke, Lepoglava
Gavrilovićeva salama  - mesni proizvod, proizvodi Mate Gavrilovića potomci d.o.o., Petrinja
Gavrilovićev kulen - mesni proizvod, proizvodi Mate Gavrilovića potomci d.o.o., Petrinja
Voštane dalmatinski pršut - mesni proizvod, proizvodi Pršut Voštane d.o.o., Trilj
Dalmatinski pršut Mataš - mesni proizvod, proizvodi Mataš M.N. d.o.o., Jasenice
Svježe svinjsko meso - mesni proizvod, proizvodi Mesnice Fiolić d.o.o., Zagreb
Mikadomliječna čokolada s rižom – slatkiš, proizvodi Zvečevo d.d., Požega
Centrix - programska podrška, Omega software d.o.o., Zagreb
Luxal - kemijski proizvod, Chromos boje i lakovi d.d., Zagreb
Chromoden lak za parkete - kemijski proizvod, Chromos boje i lakovi d.d., Zagreb
Brac fini sapuni - Brac fini sapuni, Postira, otok Brač
Porotherm - protupotresni blok, Wienerberger Ilovac d.d., Karlovac
Pištolj - HS 2000 i HS XD - oružje, proizvodi HS Produkt d.o.o., Karlovac
Zlatno zrno žita - beskvasni kruh, integralni kruh, Prehrambeno-industrijski kombinat d.d., Rijeka
Zlatno zrno žita - miješani ječmeni kruh, miješani zobeni kruh, miješani heljdin kruh, Prehrambeno-industrijski kombinat d.d., Rijeka
Zlatno zrno žita - integralni medenjaci, integralni vanilija keksi, Prehrambeno-industrijski kombinat d.d., Rijeka
Varaždinsko bučino ulje – ulje, proizvodi Prehrana d.o.o., Varaždin
Podravka goveđi gulaš – mesni proizvod, proizvodi Danica mesna industrija d.o.o., Koprivnica
Varaždinsko kiselo zelje  - Prehrana d.o.o., Varaždin
Varaždinska kisela repa  - Prehrana d.o.o., Varaždin
Baranjski kulen  – mesni proizvod, Belje d.d., Mesna industrija, Darda
Dalmatinska pečenica Mataš  – mesni proizvod, proizvodi Mataš M.N. d.o.o., Jasenice
Maraschino  -  liker, proizvodi Maraska d.d., Zadar
Požeška viljamovka  – rakija, proizvodi Willijams, Požega
Penkala kemijske olovke  – TOZ Penkala d.d., Zagreb
Penkala nalivpera  - TOZ Penkala d.d., Zagreb
Zagorski štrukli   – desert, proizvodi Palace delikatese d.o.o., Zagreb
Miris - metodika za projektiranje informacijskih sustava, verzija 2.0    -  programska podrška, Ris d.o.o., Rijeka
Učilica  – igra, Markot.tel d.o.o., Zagreb
Perpetuum Mobile iSite3  – programska podrška, Perpetuum Mobile d.o.o., Zagreb
Dingač  - vrhunsko vino, barrique i arhivsko vino, proizvodi Dingač poljoprivredna zadruga i vinarija, Potomje
Postup  - vrhunsko vino i arhivsko vino, proizvodi Dingač poljoprivredna zadruga i vinarija, Potomje
Pošip Smokvica  - vrhunsko vino, proizvodi Jedinstvo PZ, Smokvica, otok Korčula
Rukatac Smokvica  - vrhunsko vino,  proizvodi Jedinstvo PZ,  Smokvica, otok Korčula
Ivan Dolac  - vrhunsko vino, barrigue i arhivsko vino, proizvodi Svirče poljoprivredna zadruga i vinarija, Vrbanj, otok Hvar
Dimsi  - mliječni proizvod, proizvodi Dukat d.d. Zagreb
Podravec  - mliječni proizvod, proizvodi Dukat d.d. Zagreb
Zagrebački sir  - mliječni proizvod, proizvodi Dukat d.d. Zagreb
Benkovački kamen   – građevinski materijal, proizvodi Kamen Benkovac d.o.o., Benkovac
Tradicionalni kosokutni lijes rezbaren tropletom - model 80  – pogrebna oprema, proizvodi Palma d.o.o., Jastrebarsko
Teranil  – građevinski materijal, proizvodi Samoborka d.d., Samobor
Samoterm  - građevinski materijal, proizvodi Samoborka d.d.,Samobor
Terapol  - građevinski materijal, proizvodi Samoborka d.d., Samobor
Istarski kamen   vrste Kanfanar, Selina, Kirmenjak, Valtura – građevinski materijal, proizvodi Kamen d.d., Pazin
Ruho za stol  - tkani nadstolnjaci, stolnjaci i podlošci, proizvodi ETNO radiona Čehulić, Kravarsko
Umjetni mamci s ugrađenim rollo systemom   – ribolov, proizvodi Adriatic M&M d.o.o., Bregana
ECDLBOX   – obrazovni materijal, KING ICT d.o.o., Zagreb
Kolekcija Dubrovački nakit   – obrada zlata, Zlatarna Križek, Velika Gorica
Bermet Filipec    – alkoholno piće, proizvodi Obitelj Filipec - obrt za vinogradarstvo, proizvodnju i trgovinu, Samobor
Pošip    - vrhunsko vino, proizvodi Pošip poljoprivredna zadruga, Čara, otok Korčula
UBS21    – programska podrška, N-LAB d.o.o., Zagreb
Radiolink RL 2 GHz     – radijski modul, proizvodi Zagrel Rittmeyer d.o.o., Zagreb
Dalmatinski pršut - Premium    -  proizvodi Mijukić Prom, Runovići
Studenački pršut   - dalmatinski pršut, proizvodi Gradina, Studenci
Žlahtina Toljanić    - kvalitetno vino, proizvodi Gospoja P.Z., Vrbnik
Poljanski šaran    – riba, proizvodi Ribnjačarstvo Poljana d.d., Kaniška Iva
Imotska torta    – desert, proizvodi Dujmex d.o.o., Imotski
Imotski rafioli    – slatkiš, proizvodi Dujmex d.o.o., Imotski
Zlatna vrbnička žlahtina  – kvalitetno vino, proizvodi Poljoprivredna zadruga Vrbnik, Vrbnik
Torkul    - ekstra djevičansko ulje, proizvodi Fanito, obrt za poljoprivrednu proizvodnju i trgovinu, Vela Luka
Vrgorački pršut    – dalmatinski pršut, proizvodi Mesna industrija Braća Pivac d.o.o., Vrgorac
e-Kids BOX    – pomoć pri učenju, Pro-mil d.o.o., Varaždin
Marco Polo (maslinovo ulje)    - ekstra djevičansko maslinovo ulje, Blato 1902 d.d., Blato, otok Korčula
Jurek    – domaći kukuruzni kruh, proizvodi Pekarnica Latica d.o.o., Varaždin
Caprilo   – meki masni sir od kozjeg mlijeka s plemenitom plijesni, proizvodi Vindija d.d., Varaždin
Capro blue    – meki masni sir od kozjeg mlijeka s plemenitom plijesni, proizvodi Vindija d.d., Varaždin
Capron   – meki masni sir od kozjeg mlijeka,  proizvodi Vindija d.d., Varaždin
Vrša na sklapanje   - ribolov, proizvodi Obrt za proizvodnju Trapula, Marina
Caprodur    - tvrdi sir od kozjeg mlijeka,  proizvodi Vindija d.d., Varaždin
Ovidur    - tvrdi sir od ovčjeg mlijeka,  proizvodi Vindija d.d., Varaždin
Varaždinski svježi sir u sirnoj marami    - proizvodi Vindija d.d., Varaždin
Ekstra djevičansko i djevičansko maslinovo ulje   – proizvodi Poljoprivredna zadruga Marina, Marina
Kapljice    - gazirana prirodna mineralna voda, proizvodi Kalničke vode Bio Natura d.d., Križevci
Smrznuti kvarnerski škamp    - prehrambeni proizvod
Badel Pelinkovac    - liker, proizvodi Badel 1862. d.d.
Dalmatinski pršut    – mesni proizvod, proizvodi MEL (Mesnice Lovrić), Hrvace
Slavonski kulen   – mesni proizvod, proizvodi Mesoprerada
Smib    - poučno-zabavni časopis za djecu koji izdaje Školska knjiga
Modra lasta    -  poučno-zabavni časopis za učenike osnovne škole koji izdaje Školska knjiga
Lećevački sir    - sir iz mjesta Lećevica
Sisačka salama - mesni proizvod sa šireg područja Siska, proizvodi Promes-Cvanciger iz Siska.


== Zanimljivosti ==
Na listi nosioca znaka Izvorno hrvatsko nekada se nalazio i proizvod koji se zvao Poslovni informacijski sustav Posls verzija 2.xxx koji je kao programsku podršku na tržište plasirao Infosistem d.d. iz Zagreba, ali je izbrisan s liste zbog nezadovoljavanja uvjeta.


== Izvori ==


== Povezani članci ==
Znanost u Hrvatskoj
Hrvatska kulturna baština
Kroativ


== Vanjske poveznice ==
Hrvatska gospodarska komora
HrvatskiProizvod.com  Inačica izvorne stranice arhivirana 16. siječnja 2009.