revision: 11018735
title: Why Rock the Boat?
url: https://da.wikipedia.org/wiki/Absolute_Hits_Of_The_50%27s


---

Absolute Hits Of The 50s er et dansk opsamlingsalbum udgivet i 1998 af EVA Records i serien af Absolute Hits Of-albums. Albummet er en dobbelt-cd bestående af nogle af de største hits fra 1950'erne.


== Spor ==


=== Cd 1 ===
Everly Brothers – Wake Up Little Susie
Cliff Richard – Living Doll
Connie Francis – Stupid Cupid
Laurie London – He's Got The Whole World In His Hand
Wilbert Harrison – Kansas City
Carl Perkins – Blue Suede Shoes
Neil Sedaka – Oh Carol
Lloyd Price – Personality
Frankie Lymon & The Teenagers – Why Do Fools Fall In Love
Bill Haley and His Comets – (We're Gonna) Rock Around The Clock
Carl Mann – Mona Lisa
Roy Orbison – Ooby Dooby
Emile Ford & The Checkmates – What Do You Want To Make Those Eyes At Me For?
Jerry Lee Lewis – Great Balls Of Fire
Little Anthony & The Imperials – Tears On My Pillow
Eddie Cochran – Summertime Blues
Gene Vincent – Be-Bop-A-Lula
Tommy Steele – Handful Of Songs
Danny & The Juniors – At The Hop
Big Bopper – Chantilly Lace
Fats Domino – Blueberry Hill
Jerry Keller – Here Comes Summer
Larry Williams – Bony Moronie
Richie Valens – Donna
Chris Barber's Jazz Band – Petite Fleur


=== Cd 2 ===
Marty Wilde – A Teenager In Love
Chordettes – Lollipop
Johnny And The Hurricanes – Red River Rock
Buddy Holly – Peggy Sue
Phil Phillips And The Twilights – Sea Of Love
Coasters – Charlie Brown
Little Richard – Tutti Frutti
The Kingston Trio – Tom Dooley
Johnny Otis Show – Ma He's Making Eyes At Me
Ray Charles – I Got A Woman
The Platters – Only You
Tennessee Ernie Ford – Sixteen Tons
Bobby Darin – Splish Splash
Rick Nelson – Poor Little Fool
Diamonds – Little Darlin'
Bo Diddley – Bo Diddley
Fabian – Tiger
Jackie Wilson – Reet Petite
Pat Boone – I'll Be Home
Conway Twitty – It's Only Make Believe
Bobby Helms – My Special Angel
Kalin Twins – When
Freddie Bell & The Bellboys – Giddy-Up-A-Ding-Dong
The Champs – Tequila
Harry Belafonte – Banana Boat (Day-O)


== Eksterne henvisninger ==
Absolute Hits Of The 50's front- og backcover Arkiveret 16. november 2007 hos  Wayback Machine