revision: 11018753
title: Summer Again
url: https://da.wikipedia.org/wiki/Absolute_Summer_vol._1


---

Absolute Summer vol. 1, kompilation i serien Absolute Summer udgivet i 2001. Albummet er en dobbelt-cd bestående af sommerhits.


== Spor ==


=== Disc 1 ===
LeAnn Rimes – "Can't Fight The Moonlight" (Latino Mix)
Zididada – "Zididada Day"
Antique – "(I Would) Die For You"
Lou Bega – "Mambo No. 5 (A Little Bit Of...)"
The Mavericks – "Dance The Night Away"
Vengaboys – "We're Going To Ibiza!"
Fabrizio Faniello – "Another Summer Night"
Roy Orbison – "California Blue"
Sunny Face – "The Sunny Cha Cha Cha"
The Beach Boys – "California Girls"
CJ Lewis – "Sweets For My Sweet"
Sunzet – "If We Ever Fall In Love Again"
Shaggy – "In The Summertime"
Chico & The Gypsies – "Marina"
Shaft – "(Mucho Mamba) Sway"
Geri Halliwell – "Mi Chico Latino"


=== Disc 2 ===
Baha Men – "Who Let The Dogs Out"
Los del Rio – "Macarena"
Laid Back – "Sunshine Reggae 2000"
Lionel Richie – "All Night Long"
Chaka Demus & The Pliers – "Tease Me"
Los Umbrellos – "No Tengo Dinero"
DJ Mendez – "Fiesta (House Party)"
Prima Donna feat. Linda Scott – "Dam Da Dam (Why Haven't I Told You)"
Inner Circle – "Sweat (A La La La La Long)"
Pato Banton – "Baby Come Back"
Texas – "Summer Son"
Dario G – "Carnival de Paris"
Bob Marley vs. Funstar Deluxe – "Sun Is Shining"
Afro Medusa – "Pasilda"
De La Soul feat. Chaka Khan – "All Good?"
Barry Manilow – "Copacabana (At The Coba)"


== Eksterne henvisninger ==
Absolute Summer vol. 1 front- og backcover (Webside ikke længere tilgængelig)