revision: 9874193
title: Gad Elmaleh
url: https://el.wikipedia.org/wiki/%CE%9F%CE%B9_%CE%9C%CE%AC%CE%B3%CE%BF%CE%B9_%CF%84%CE%B7%CF%82_%CE%9C%CF%80%CE%AC%CE%BB%CE%B1%CF%82


---

Το Οι Μάγοι της Μπάλας (γαλλικά: Les Seigneurs) είναι γαλλική ταινία σε σκηνοθεσία του Ολιβιέ Νταάν, η οποία κυκλοφόρησε στη Γαλλία στις 26 Σεπτεμβρίου 2012.


== Περίληψη ==
Ένα παλιό αστέρι του ποδοσφαίρου και νυν προπονητής στα όρια της κατάθλιψης, καλεί τους πρώην συμπαίκτες του για να σώσουν την κονσερβοποιία της νήσου της Μολέν από τη χρεοκοπία, βοηθώντας την άσημη τοπική ομάδα να προκριθεί στον θεσμό του Κυπέλλου Γαλλίας.


== Ομάδα Παραγωγής ==
Αρχικός τίτλος : Les Seigneurs
Σκηνοθεσία : Ολιβιέ ΝταάνΠαραγωγή

Εκλεγμένος παραγωγός : Ιζαάκ Σαρί
Συντονίστρια παραγωγής : Ζυστίν Φιλμπέρ
Βοηθός παραγωγού : Ανιές Φυστιέ-Νταάν
Εκτελεστικός παραγωγός : Ζαν-Υβ ΑσελένΣενάριο

Σεναριογράφος : Φιλίπ ντε Σωβερόν και Μαρκ ντε Σωβερόν
Κειμενογράφος : Βιρζινί Λε Πιονιέ
Μουσική της Ταινίας : Γκιγιόμ Ρουσέλ
Παραγωγή : Vito Films
Συμπαραγωγή : O.D. SHOTS και TF1 Films Production
Συμμετοχή : Canal+ CINE + et TF1
Διανομή : Γαλλία : Warner Bros.Είδος : Κωμωδία
Ημερομηνίες κυκλοφορίας :
 Βρετάνη : 19 Σεπτεμβρίου 2012
 Γαλλία,  Βέλγιο : 26 Σεπτεμβρίου 2012


== Ηθοποιοί ==
Ζοζέ Γκαρσιά : Πατρίκ Ορμπερά
Ζαν-Πιέρ Μαριέλ : ο δήμαρχος Τιτουάν Λεγκενέκ
Φρανκ Ντυμπός : Νταβίντ Λεαντρί
Γκαντ Ελμαλέχ : Ραγιάν Ζιανί
JoeyStarr : Σαχίφ Μπερντά
Ραμζί Μπεντιά : Μαραντελά
Ομάρ Σι : Γουεκέ Ν'Ντογκό
Le comte de Bouderbala : ο ψαράς Λε Πενίς (γνωστός κι ως Λε Πεν)
Φρεντερίκ Μπελ : Φλοριά
Κλεμαντίν Μπαέρτ : Αν Λεγκενέκ, η κόρη του δημάρχου
Αντρέ Πενβέρν : Φουσέ
Λυντοβίκ Μπερτιγιό : Γκουβερνέκ
Φρανσουά Μπυρλού : Κερνέλ
Ελιζαμπέτ Κομελάν : η δικαστής
Σέρχιο ντο Βάλε : ο ποδοσφαιριστής Κερμπιχάν
Σεμπαστιάν Λιμπεσάρ : Ντεμπέκ
Ριτόν Λιεμπμάν : ο δικαστικός κλητήρας
Σαντάλ Νόιγουϊρτ : Νενέν
Κλοντιά Ταγκμπό : Φατού Ν'Ντογκό, τη γυναίκα του Γουεκέ
Λυκά Ρενώ : Εργουάν
Ζαν Ρενό : ο ίδιος
Ελενά Ζουαλέγκ : Λουίζ, η κόρη του Πατρίκ Ομπερά
Φερνάντο Λάρα
Μαρκ Ριουφόλ
Βανεσά Γκιντ : Σαρλότ


== Διάφορα ==
Αν και αρχικώς είχε προβλεφτεί για τις 11 Απριλίου 2012, η υποβολή σε καθεστώς εκκαθάρισης της εταιρείας ειδικών εφέ Quinta Industries, οδήγησε στην αναβολή της πρώτης προβολής της ταινίας για τις 26 Σεπτεμβρίου 2012.


== Σημειώσεις και παραπομπές ==