revision: 281031
title: "Il-\u0120img\u0127a"
url: https://mt.wikipedia.org/wiki/Lingwa_Pollakka


---

Pollakk (Pollakk: język polski, [ˈjɛ̃zɨk ˈpɔlskʲi], polszczyzna [pɔlˈʂt͡ʂɨzna] jew sempliċiment polski, [ˈpɔlskʲi]) hija lingwa Slava tal-Punent tal-grupp Lekitiku, miktuba. Huwa mitkellem primarjament fil-Polonja u jservi bħala l-lingwa nattiva tal-Pollakki. Minbarra li hija l-lingwa uffiċjali tal-Polonja, tintuża wkoll mid-dijaspora Pollakka. Hemm aktar minn 50 miljun kelliem Pollakk madwar id-dinja. Hija tinsab fis-sitt post fost il-lingwi tal-Unjoni Ewropea. Il-Pollakk huwa suddiviż f'djaletti reġjonali u jżomm pronomi ta' distinzjoni T–V stretti, onoriċi u diversi forom ta' formalitajiet meta jindirizza individwi.


== L-alfabett ==
Aa Ąą Bb Cc Ćć Dd Ee Ęę Ff Gg Hh Ii Jj Kk Ll Łł Mm Nn Ńń Oo Óó Pp Rr Ss Śś Tt Uu Ww Yy Zz Źź Żż


== Eżempji tal-Lingwa Pollakka ==
Il-Ġranet tal-Ġimgħa
It-Tnejn: poniedziałek
It-Tlieta: wtorek
L-Erbgħa: środa
Il-Ħamis: czwartek
Il-Ġimgħa: piątek
Is-Sibt: sobota
Il-Ħadd: niedziela
Ix-Xhur tas-Sena
Jannar: styczeń
Frar: luty
Marzu: marzec
April: kwiecień
Mejju: maj
Ġunju: czerwiec
Lulju: lipiec
Awwissu: sierpień
Settembru: wrzesień
Ottubru: październik
Novembru: listopad
Diċembru: grudzień
In-Numri 
Wieħed: jeden
Tnejn: dwa
Tlieta: trzy
Erbgħa: cztery
Ħamsa: pięć
Sitta: sześć
Sebgħa: siedem
Tmienja: osiem
Disgħa: dziewięć
Għaxra: dziesięć