revision: 5819532
title: Svetimi (1962 m. filmas)
url: https://lt.wikipedia.org/wiki/Svetimi_(1962_m._filmas)


---

Svetimi- 1962 m. Lietuvos kino studijoje sukurtas meninis filmas. Drama. Filmo trukmė - 70 min.


== Kūrybinė grupė ==
Scenarijaus autoriai - Antanas Jonynas, Juozas Požėra
Režisierius statytojas - Marijonas Giedrys
Kompozitorius - Juozas Indra
Operatoriai - Algirdas Araminas, Robertas Verba
Montažo režisierius - Mingailė Murmulaitienė
Dailininkas statytojas - Algirdas Ničius
Garso operatorius - Stasys Vilkevičius
Kostiumų dailininkai - Nijolė Klišiūtė, Elena Emma.


== Vaidina ==
Gražina Balandytė - Irena
Stasys Petronaitis - Antanas Doveika
Bronius Babkauskas - Vilkišius
Albertas Šulcas - Edvardas
Kazimiera Kymantaitė - Čepėnienė, jo motina
Napoleonas Nakas - dėdė Kazimieras
Konstancija Bialopetraviečienė - Elvyra, Vilkišiaus draugė
Kęstutis Staneika - Jonas
Aleksandras Kernagis - duobkasys
Aurelija Mikušauskaitė - Irenos bendravardė
taip pat Vincas Aleknavičius, Valdas Jatautis, Eugenijus Ignatavičius, Aleksandras Šimanskis, Algis Šveikauskas, S. Eidukaitytė, S. Marcinkevičius, N. Vikonytė ir kiti.


== Siužetas ==


== Festivaliai, apdovanojimai ==
1962 m. - Pabaltijo ir Baltarusijos kino festivalio diplomai A. Ničiui už geriausią dailininko darbą ir B. Babkauskui už geriausią vyro vaidmenį.


== Nuorodos ==
Filmo svetainė
Filmo ištraukos