revision: 6724434
title: Ledynmetis 4
url: https://lt.wikipedia.org/wiki/Ledynmetis_4


---

Ledynmetis 4: Žemynų atsiradimas (angl. Ice Age: Continental Drift) – animacinė komedija, pasirodysianti šių metų liepos 4 d. (Lietuvoje – liepos 6 d.).
Filmo leidėjas – Blue Sky Studios, platintojas – 20th Century Fox. Tai yra ketvirtoji Ledynmečio frančizės dalis, pirmosios trys: Ledynmetis, Ledynmetis 2: Eros pabaiga, Ledynmetis 3: Dinozaurų eros pradžia. Šis filmas bus antrasis filmų serijoje 3D formatu. Pirmasis buvo Ledynmetis 3: Dinozaurų Eros pradžia. Animacinė komedija režisuota Steve Martino ir Mike Thurmeier.


== Įgarsintojai ==
Įgarsinęs aktorius – filmo veikėjasPeter Dinklage – Kapitonas Gutas
Kunal Nayyar – Gupta
Jennifer Lopez – Šyra
Seann William Scott – Bakas
Alan Tudyk – Miltonas, Fabio Slotas
Queen Latifah – Elė
John Leguizamo – Sidas
Keke Palmer – Persikutė
Heather Morris – Keitė
Aziz Ansari – Skvintas
Josh Peck – Edis
Nick Frost – Flinas
Rebel Wilson – Razas
Denis Leary – Diegas
Ray Romano – Menis
Aubrey Graham – Etanas
Josh Gad – Luis
Wanda Sykes – Močiutė
Nicki Minaj – Stefė
Alain Chabat – Silas
Joy Behar – Eunicė
Chris Wedge – Skretas
Jason Fricchione – Krabas
Ben Gleib – Maršalas
Ester Dean – Sloth Siren
Ally Romano – Megan
Matthew Simmons – Elkas


== Nuorodos ==
Oficialus filmo puslapis Archyvuota kopija 2012-02-12 iš Wayback Machine projekto.
IMDb straipsnis