revision: 181991702
title: Politics
url: https://fr.wikipedia.org/wiki/%C3%89lection_orageuse


---

Élection orageuse (titre original : Politics) est un film américain réalisé par Charles Reisner, sorti en 1931.


== Synopsis ==
Le crime et la corruption est endémique à Lake City et alors que le maire corrompu se présente pour un nouveau mandat, dont il a beaucoup de chance qu'il remportera, les femmes de la ville, dégoûtées de la situation, décident d'agir. Elles demande à Hattie Burns de se présenter contre lui qui accepte. Très vite, Le groupe des femmes et le groupe des hommes politique devient une véritable bataille des sexes. En fin de compte, après une fastidieuses campagne où tous les coups sont permit Hattie glisse vers la victoire.


== Fiche technique ==
Titre original : Politics
Titre français : Élection orageuse
Réalisation : Charles Reisner
Scénario : Zelda Sears, Malcolm Stuart Boylan, Wells Root et Robert E. Hopkins
Direction artistique : Cedric Gibbons
Photographie : Clyde De Vinna
Montage : William S. Gray
Pays d'origine :  États-Unis
Format : Noir et blanc — 35 mm — 1,37:1 — Son : Mono
Genre : Comédie
Date de sortie : 1931


== Distribution ==
Marie Dressler : Hattie Burns
Polly Moran : Ivy Higgins
Roscoe Ates : Peter Higgins
Karen Morley : Myrtle Burns
William Bakewell : Benny Emerson
John Miljan : Jim Curango
Joan Marsh : Daisy Evans
Tom McGuire : Tom Collins
Mary Alden : Mrs. Mary Evans
DeWitt Jennings : Chef de la police
Wilfred Lucas : Edgar
Lee Phelps : Détective
Herbert Prior : Abner
Claire Du Brey
Robert Dudley
Ann Dvorak


== Liens externes ==
Ressources relatives à l'audiovisuel : (en) AllMovie (en) IMDb (en) Movie Review Query Engine (mul) The Movie Database 
 Portail du cinéma américain   Portail des années 1930