revision: 29732027
title: "Mikronezya'daki \u015Fehirler listesi"
url: https://tr.wikipedia.org/wiki/%C3%9Clkelere_g%C3%B6re_%C5%9Fehirler_listesi


---

Aşağıda Birleşmiş Milletler tarafından bağımsız, egemen bir ülke olarak kabul edilen ve Birleşmiş Milletler'de üyeliği bulunan 193 ülke ile egemen bir devlet olarak kabul edilen ancak BM'de üyeliği bulunmayan Vatikan dahil toplam 194 ülkenin şehirler listesi ile yine ayrıca Birleşmiş Milletler üyesi en az bir ülke tarafından bağımsızlığı kabul edilen 9 ülkeye ait şehirler listesi yer almaktadır. Birleşmiş Milletler üyesi tüm ülkeler tarafından bağımsızlığı kabul görmeyen bu ülkelerin isimleri italik olarak yazılmıştır.


== A ==
 Abhazya'daki şehirler listesi - Abhazya
 Afganistan'daki şehirler listesi - Afganistan
 Almanya'daki şehirler listesi - Almanya
 Amerika Birleşik Devletleri'ndeki şehirler listesi - Amerika Birleşik Devletleri
 Andorra'daki şehirler listesi - Andorra
 Angola'daki şehirler listesi - Angola
 Antigua ve Barbuda'daki şehirler listesi - Antigua ve Barbuda
 Arjantin'deki şehirler listesi - Arjantin
 Arnavutluk'taki şehirler listesi - Arnavutluk
 Avustralya'daki şehirler listesi - Avustralya
 Avusturya'daki şehirler listesi - Avusturya
 Azerbaycan'daki şehirler listesi - Azerbaycan


== B ==
 Bahama Adaları'ndaki şehirler listesi - Bahamalar
 Bahreyn'deki şehirler listesi - Bahreyn
 Bangladeş'teki şehirler listesi - Bangladeş
 Barbados'taki şehirler listesi - Barbados
 Beyaz Rusya'daki şehirler listesi - Belarus
 Belçika'daki şehirler listesi - Belçika
 Belize'deki şehirler listesi - Belize
 Benin'deki şehirler listesi - Benin
 Bhutan'daki şehirler listesi - Bhutan
 Birleşik Arap Emirlikleri'ndeki şehirler listesi - Birleşik Arap Emirlikleri
 Birleşik Krallık'taki şehirler listesi - Birleşik Krallık
 Bolivya'daki şehirler listesi - Bolivya
 Bosna-Hersek'teki şehirler listesi - Bosna-Hersek
 Botsvana'daki şehirler listesi - Botsvana
 Brezilya'daki şehirler listesi - Brezilya
 Brunei'deki şehirler listesi - Brunei
 Bulgaristan'daki şehirler listesi - Bulgaristan
 Burkina Faso'daki şehirler listesi - Burkina Faso
 Burundi'deki şehirler listesi - Burundi


== C ==
 Cezayir'deki şehirler listesi - Cezayir
 Cibuti'deki şehirler listesi - Cibuti
 Cook Adaları'ndaki şehirler listesi - Cook Adaları


== Ç ==
 Çad'daki şehirler listesi - Çad
 Çek Cumhuriyeti'ndeki şehirler listesi - Çekya
 Çin'deki şehirler listesi - Çin


== D ==
 Danimarka'daki şehirler listesi - Danimarka
 Kongo Demokratik Cumhuriyeti'ndeki şehirler listesi - Kongo Demokratik Cumhuriyeti
 Doğu Timor'daki şehirler listesi - Doğu Timor
 Dominika'daki şehirler listesi - Dominika
 Dominik Cumhuriyeti'ndeki şehirler listesi - Dominik Cumhuriyeti


== E ==
 Ekvador'daki şehirler listesi - Ekvador
 Ekvator Ginesi'ndeki şehirler listesi - Ekvator Ginesi
 El Salvador'daki şehirler listesi - El Salvador
 Endonezya'daki şehirler listesi - Endonezya
 Eritre'deki şehirler listesi - Eritre
 Ermenistan'daki şehirler listesi - Ermenistan
 Estonya'daki şehirler listesi - Estonya
 Etiyopya'daki şehirler listesi - Etiyopya


== F ==
 Fas'taki şehirler listesi - Fas
 Fiji'deki şehirler listesi - Fiji
 Fildişi Sahili'ndeki şehirler listesi - Fildişi Sahili
 Filipinler'deki şehirler listesi - Filipinler
 Filistin'deki şehirler listesi - Filistin
 Finlandiya'daki şehirler listesi - Finlandiya
 Fransa'daki şehirler listesi - Fransa


== G ==
 Gabon'daki şehirler listesi - Gabon
 Gambiya'daki şehirler listesi - Gambiya
 Gana'daki şehirler listesi - Gana
 Gine'deki şehirler listesi - Gine
 Gine-Bissau'daki şehirler listesi - Gine-Bissau
 Grenada'daki şehirler listesi - Grenada
 Guatemala'daki şehirler listesi - Guatemala
 Guyana'daki şehirler listesi - Guyana
 Güney Afrika Cumhuriyeti'ndeki şehirler listesi - Güney Afrika Cumhuriyeti
 Güney Kore'deki şehirler listesi - Güney Kore
 Güney Osetya'daki şehirler listesi - Güney Osetya
 Güney Sudan'daki şehirler listesi - Güney Sudan
 Gürcistan'daki şehirler listesi - Gürcistan


== H ==
 Haiti'deki şehirler listesi - Haiti
 Hırvatistan'daki şehirler listesi - Hırvatistan
 Hindistan'daki şehirler listesi - Hindistan
 Hollanda'daki şehirler listesi - Hollanda
 Honduras'taki şehirler listesi - Honduras


== I ==
 Irak'taki şehirler listesi - Irak


== İ ==
 İran'daki şehirler listesi - İran
 İrlanda'daki şehirler listesi - İrlanda
 İspanya'daki şehirler listesi - İspanya
 İsrail'deki şehirler listesi - İsrail
 İsveç'teki şehirler listesi - İsveç
 İsviçre'deki şehirler listesi - İsviçre
 İtalya'daki şehirler listesi - İtalya
 İzlanda'daki şehirler listesi - İzlanda


== J ==
 Jamaika'daki şehirler listesi - Jamaika
 Japonya'daki şehirler listesi - Japonya


== K ==
 Kamboçya'daki şehirler listesi - Kamboçya
 Kamerun'daki şehirler listesi - Kamerun
 Kanada'daki şehirler listesi - Kanada
 Karadağ'daki şehirler listesi - Karadağ
 Katar'daki şehirler listesi - Katar
 Kazakistan'daki şehirler listesi - Kazakistan
 Kenya'daki şehirler listesi - Kenya
 Kıbrıs Cumhuriyeti'ndeki şehirler listesi - Kıbrıs Cumhuriyeti
 Kırgızistan'daki şehirler listesi - Kırgızistan
 Kiribati'deki şehirler listesi - Kiribati
 Kolombiya'daki şehirler listesi - Kolombiya
 Komorlar'daki şehirler listesi - Komorlar
 Kongo Cumhuriyeti'ndeki şehirler listesi - Kongo Cumhuriyeti
 Kosta Rika'daki şehirler listesi - Kosta Rika
 Kosova'daki şehirler listesi - Kosova
 Kuveyt'teki şehirler listesi - Kuveyt
 KKTC'deki şehirlerin listesi - Kuzey Kıbrıs Türk Cumhuriyeti
 Kuzey Kore'deki şehirler listesi - Kuzey Kore
 Küba'daki şehirler listesi - Küba


== L ==
 Laos'taki şehirler listesi - Laos
 Lesotho'daki şehirler listesi - Lesotho
 Letonya'daki şehirler listesi - Letonya
 Liberya'daki şehirler listesi - Liberya
 Libya'daki şehirler listesi - Libya
 Lihtenştayn'daki şehirler listesi - Lihtenştayn
 Litvanya'daki şehirler listesi - Litvanya
 Lübnan'daki şehirler listesi - Lübnan
 Lüksemburg'daki şehirler listesi - Lüksemburg


== M ==
 Macaristan'daki şehirler listesi - Macaristan
 Madagaskar'daki şehirler listesi - Madagaskar
 Makedonya'daki şehirler listesi - Makedonya
 Malavi'deki şehirler listesi - Malavi
 Maldivler'deki şehirler listesi - Maldivler
 Malezya'daki şehirler listesi - Malezya
 Mali'deki şehirler listesi - Mali
 Malta'daki şehirler listesi - Malta
 Marshall Adaları'ndaki şehirler listesi - Marshall Adaları
 Mauritius'taki şehirler listesi - Mauritius
 Meksika'daki şehirler listesi - Meksika
 Mısır'daki şehirler listesi - Mısır
 Mikronezya'daki şehirler listesi - Mikronezya
 Moğolistan'daki şehirler listesi - Moğolistan
 Moldova'daki şehirler listesi - Moldova
 Monako'daki şehirler listesi - Monako
 Moritanya'daki şehirler listesi - Moritanya
 Mozambik'teki şehirler listesi - Mozambik
 Myanmar'daki şehirler listesi - Myanmar


== N ==
 Namibya'daki şehirler listesi - Namibya
 Nauru'daki şehirler listesi - Nauru
 Nepal'deki şehirler listesi - Nepal
 Nijer'deki şehirler listesi - Nijer
 Nijerya'daki şehirler listesi - Nijerya
 Nikaragua'daki şehirler listesi - Nikaragua
 Niue'deki şehirler listesi - Niue
 Norveç'teki şehirler listesi - Norveç


== O ==
 Orta Afrika Cumhuriyeti'ndeki şehirler listesi - Orta Afrika Cumhuriyeti


== Ö ==
 Özbekistan'daki şehirler listesi - Özbekistan


== P ==
 Pakistan'daki şehirler listesi - Pakistan
 Palau'daki şehirler listesi - Palau
 Panama'daki şehirler listesi - Panama
 Papua Yeni Gine'deki şehirler listesi - Papua Yeni Gine
 Paraguay'daki şehirler listesi - Paraguay
 Peru'daki şehirler listesi - Peru
 Polonya'daki şehirler listesi - Polonya
 Portekiz'deki şehirler listesi - Portekiz


== R ==
 Romanya'daki şehirler listesi - Romanya
 Ruanda'daki şehirler listesi - Ruanda
 Rusya'daki şehirler listesi - Rusya


== S ==
 Saint Kitts ve Nevis'in bucakları - Saint Kitts ve Nevis
 Saint Lucia'daki şehirler listesi - Saint Lucia
 Saint Vincent ve Grenadinler'deki şehirler listesi - Saint Vincent ve Grenadinler
 Sahra Demokratik Arap Cumhuriyeti'ndeki şehirler listesi - Sahra Demokratik Arap Cumhuriyeti
 Samoa'daki şehirler listesi - Samoa
 San Marino'daki şehirler listesi - San Marino
 São Tomé ve Príncipe'deki şehirler listesi - São Tomé ve Príncipe
 Senegal'deki şehirler listesi - Senegal
 Seyşeller'deki şehirler listesi - Seyşeller
 Sırbistan'daki şehirler listesi - Sırbistan
 Sierra Leone'deki şehirler listesi - Sierra Leone
 Singapur'daki şehirler listesi - Singapur
 Slovakya'daki şehirler listesi - Slovakya
 Slovenya'daki şehirler listesi - Slovenya
 Solomon Adaları'ndaki şehirler listesi - Solomon Adaları
 Somali'deki şehirler listesi - Somali
 Sri Lanka'daki şehirler listesi - Sri Lanka
 Sudan'daki şehirler listesi - Sudan
 Surinam'daki şehirler listesi - Surinam
 Suriye'deki şehirler listesi - Suriye
 Suudi Arabistan'daki şehirler listesi - Suudi Arabistan
 Esvatini'deki şehirler listesi - Esvatini


== Ş ==
 Şili'deki şehirler listesi - Şili


== T ==
 Tacikistan'daki şehirler listesi - Tacikistan
 Tanzanya'daki şehirler listesi - Tanzanya
 Tayland'daki şehirler listesi - Tayland
 Tayvan'daki şehirler listesi - Tayvan
 Togo'daki şehirler listesi - Togo
 Tonga'daki şehirler listesi - Tonga
 Trididad ve Tobago'daki şehirler listesi - Trinidad ve Tobago
 Tunus'taki şehirler listesi - Tunus
 Tuvalu'daki şehirler listesi - Tuvalu
 Türkiye'deki şehirler listesi - Türkiye
 Türkmenistan'daki şehirler listesi - Türkmenistan


== U ==
 Uganda'daki şehirler listesi - Uganda
 Ukrayna'daki şehirler listesi - Ukrayna
 Umman'daki şehirler listesi - Umman
 Uruguay'daki şehirler listesi - Uruguay


== Ü ==
 Ürdün'deki şehirler listesi - Ürdün


== V ==
 Vanuatu'daki şehirler listesi - Vanuatu
 Vatikan
 Venezuela'daki şehirler listesi - Venezuela
 Vietnam'daki şehirler listesi - Vietnam


== Y ==
 Yemen'deki şehirler listesi - Yemen
 Yeni Zelanda'daki şehirler listesi - Yeni Zelanda
 Yeşil Burun Adaları'ndaki şehirler listesi - Yeşil Burun Adaları
 Yunanistan'daki şehirler listesi - Yunanistan


== Z ==
 Zambiya'daki şehirler listesi - Zambiya
 Zimbabve'deki şehirler listesi - Zimbabve


== Kaynakça ==


== Dış bağlantılar ==
www.citypopulation.de
2005 city population estimates for the world18 Şubat 2008 tarihinde Wayback Machine sitesinde arşivlendi.
Place Names of Europe
Birleşmiş Milletler üyesi ülkeler listesi12 Nisan 2014 tarihinde Wayback Machine sitesinde arşivlendi.