revision: 28650488
title: "Kad\u0131n Severse (film)"
url: https://tr.wikipedia.org/wiki/Erkek_Severse


---

Erkek Severse, Gold Film imzalı, yönetmenliğini sırasıyla Ömür Atay ve Zeliha Orman'ın üstlendiği, senaryosunu Aslı Zengin'in yazdığı, başrollerini Alperen Duymaz, Büşra Develi, Yasemin Allen ve Görkem Sevindik'in paylaştığı, 20 Ocak 2022 tarihinde beIN CONNECT'te yayınlanmaya başlayan dram ve romantik komedi türündeki Türk yapımı internet dizisi. Dizi, 14 Nisan 2022 tarihinde yayımlanan 26. bölümüyle final yaparak sona ermiştir.


== Oyuncu kadrosu ve karakterler ==
Alperen Duymaz - Kenan Acarsoy
Büşra Develi - Zeynep Uysal
Yasemin Allen - Yelda Sipahi
Görkem Sevindik - Oktay Durmaz
Yağız Can Konyalı - Cenk Dönmez
Aslı Sümen - Ezgi Uysal
Tolga Güleç - Hakan
Asena Tuğal - Işıl
Çağrı Çıtanak - Mete Egemen
Seren Deniz Yalçın - Sena
Ece Özdikici - Cansu Acarsoy
Bahar Süer - Demet
Ayşe Dudu Özdemir  - Şeyma
Tahir Yılmaz - Cüneyt
Ayşe Akın - Şeyma
Tuana Gizem Uzunlar - Ebru
Betül Arım - Nermin
Tarık Uğur Özenbaş - Erhan
Berkay Celal Çetin - Kaan
Kayra Orta - Beste
Rüzgar Can - Arda


== Genel bakış ==


== Bölümler ==


=== 1. sezon (2022) ===


== Dış bağlantılar ==
beIN CONNECT'in resmî sitesinde Erkek Severse
Twitter'da Erkek Severse
Instagram'da Erkek Severse
IMDb'de Erkek Severse


== Kaynakça ==